,Unnamed: 0,review_date,helpful_votes,total_votes,weighted_votes,weighted_ratings,culmulative_weighted_rating
0,0,2004-06-19,122,135,110,220,220
1,1,2004-06-21,6,6,7,0,220
2,2,2004-06-25,19,19,20,20,240
3,3,2004-07-20,20,53,-12,0,240
4,4,2004-09-13,12,14,11,-11,229
5,5,2004-09-18,31,33,30,-60,169
6,6,2004-09-30,12,16,9,-18,151
7,7,2004-11-19,9,13,6,12,163
8,8,2004-11-20,16,19,14,-28,135
9,9,2004-12-10,56,61,52,0,135
10,10,2005-01-20,93,98,89,178,313
11,11,2005-07-27,5,5,6,12,325
12,12,2005-10-06,11,13,10,10,335
13,13,2005-10-09,6,8,5,5,340
14,14,2005-10-27,32,33,32,32,372
15,15,2005-11-16,11,16,7,14,386
16,16,2005-12-28,0,0,1,-1,385
17,17,2006-06-23,0,0,1,-2,383
18,18,2007-01-04,6,10,3,6,389
19,19,2007-02-18,5,6,5,5,394
20,20,2007-02-20,6,7,6,12,406
21,21,2007-03-28,6,7,6,12,418
22,22,2007-06-09,11,11,12,24,442
23,23,2007-07-28,3,5,2,2,444
24,24,2007-08-13,6,7,6,12,456
25,25,2007-08-29,10,13,8,-16,440
26,26,2007-09-09,0,0,1,1,441
27,27,2007-11-24,6,6,8,12,453
28,28,2007-12-01,14,16,13,26,479
29,29,2007-12-27,43,44,43,86,565
30,30,2007-12-31,7,9,6,12,577
31,31,2008-02-22,7,7,8,16,593
32,32,2008-02-24,11,19,4,-8,585
33,33,2008-02-29,6,7,6,12,597
34,34,2008-03-31,2,3,2,0,597
35,35,2008-04-14,2,2,3,-3,594
36,36,2008-05-17,19,22,17,34,628
37,37,2008-05-18,95,100,91,182,810
38,38,2008-05-21,7,8,7,14,824
39,39,2008-05-23,184,189,180,-360,464
40,40,2008-05-27,87,94,81,-162,302
41,41,2008-07-17,4,4,5,-10,292
42,42,2008-07-18,2,3,2,4,296
43,43,2008-07-21,19,25,14,-14,282
44,44,2008-08-05,18,23,14,-14,268
45,45,2008-08-18,6,16,-3,-6,262
46,46,2008-08-30,3,17,-10,-10,252
47,47,2008-10-08,7,20,-5,5,257
48,48,2008-10-09,72,74,72,75,332
49,49,2008-10-12,10,11,10,-10,322
50,50,2008-10-13,74,80,71,110,432
51,51,2008-10-25,7,7,8,8,440
52,52,2008-12-29,3,4,3,3,443
53,53,2009-04-29,4,5,4,8,451
54,54,2009-07-22,61,69,54,-108,343
55,55,2009-08-15,2,3,2,-4,339
56,56,2009-10-28,5,6,6,12,351
57,57,2009-10-29,169,177,162,324,675
58,58,2009-11-20,20,21,20,-40,635
59,59,2009-11-27,10,10,11,-22,613
60,60,2009-12-05,4,4,5,-10,603
61,61,2009-12-07,13,16,11,0,603
62,62,2009-12-18,21,36,8,-22,581
63,63,2010-02-07,70,73,69,138,719
64,64,2010-02-10,3,4,3,6,725
65,65,2010-02-24,20,21,21,-33,692
66,66,2010-02-26,4,7,3,-5,687
67,67,2010-03-16,0,0,1,-1,686
68,68,2010-03-17,2,2,3,3,689
69,69,2010-03-18,3,4,3,6,695
70,70,2010-03-20,4,6,3,-6,689
71,71,2010-04-10,1,1,2,4,693
72,72,2010-04-15,5,5,6,-12,681
73,73,2010-04-21,0,0,1,-2,679
74,74,2010-04-28,3,5,2,-4,675
75,75,2010-05-10,1,1,2,2,677
76,76,2010-06-19,8,8,9,0,677
77,77,2010-07-16,5,5,6,-12,665
78,78,2010-07-25,6,8,5,5,670
79,79,2010-08-11,5,6,5,-5,665
80,80,2010-08-12,4,6,3,3,668
81,81,2010-08-24,0,0,1,-1,667
82,82,2010-08-25,5,6,5,10,677
83,83,2010-08-26,5,8,3,-3,674
84,84,2010-09-17,1,1,2,0,674
85,85,2010-11-24,6,8,5,10,684
86,86,2010-11-27,28,30,27,-54,630
87,87,2010-12-01,2,2,3,3,633
88,88,2010-12-12,0,0,1,2,635
89,89,2011-01-08,0,0,1,-2,633
90,90,2011-01-09,23,23,25,50,683
91,91,2011-01-13,1,1,2,-4,679
92,92,2011-01-16,9,10,9,18,697
93,93,2011-01-21,4,4,5,-10,687
94,94,2011-02-02,0,0,1,-1,686
95,95,2011-02-05,4,4,5,-10,676
96,96,2011-02-09,2,6,-1,2,678
97,97,2011-02-16,28,30,27,-54,624
98,98,2011-02-20,10,13,8,-16,608
99,99,2011-02-22,7,8,7,14,622
100,100,2011-03-03,0,0,1,0,622
101,101,2011-03-19,2,3,2,-4,618
102,102,2011-03-20,4,5,4,4,622
103,103,2011-04-04,0,0,1,-2,620
104,104,2011-04-05,31,39,24,-24,596
105,105,2011-04-06,4,7,2,-2,594
106,106,2011-04-07,4,4,5,5,599
107,107,2011-04-18,8,11,6,12,611
108,108,2011-04-19,6,8,5,10,621
109,109,2011-04-21,3,5,2,0,621
110,110,2011-04-22,2,2,3,6,627
111,111,2011-04-24,131,134,129,258,885
112,112,2011-05-06,6,7,6,-12,873
113,113,2011-05-11,14,20,9,0,873
114,114,2011-05-25,1,3,0,0,873
115,115,2011-06-09,2,3,2,-2,871
116,116,2011-06-15,1,4,-1,2,873
117,117,2011-06-22,12,17,9,-18,855
118,118,2011-07-05,1,1,2,-4,851
119,119,2011-07-18,2,2,3,-6,845
120,120,2011-07-19,2,3,2,0,845
121,121,2011-07-29,27,32,23,0,845
122,122,2011-07-30,1,3,0,0,845
123,123,2011-08-02,2,4,1,2,847
124,124,2011-08-08,2,2,3,3,850
125,125,2011-08-18,0,0,1,-2,848
126,126,2011-08-23,4,4,5,10,858
127,127,2011-08-29,5,7,4,-8,850
128,128,2011-09-10,2,4,1,-2,848
129,129,2011-09-11,2,2,3,3,851
130,130,2011-09-16,2,3,2,-2,849
131,131,2011-09-19,22,26,20,36,885
132,132,2011-09-21,3,5,2,-4,881
133,133,2011-09-22,4,4,5,-10,871
134,134,2011-10-16,11,17,7,14,885
135,135,2011-11-06,3,3,4,4,889
136,136,2011-11-14,11,11,14,-22,867
137,137,2011-11-17,3,3,4,-8,859
138,138,2011-11-24,2,2,3,3,862
139,139,2011-12-07,12,15,10,0,862
140,140,2011-12-11,1,1,2,2,864
141,141,2011-12-17,8,9,8,8,872
142,142,2011-12-23,3,3,5,-2,870
143,143,2011-12-25,44,46,43,43,913
144,144,2011-12-28,18,22,15,-30,883
145,145,2011-12-29,7,7,9,-18,865
146,146,2011-12-30,5,8,4,-8,857
147,147,2012-01-04,372,380,365,730,1587
148,148,2012-01-05,1,1,2,-4,1583
149,149,2012-01-08,5,6,5,10,1593
150,150,2012-01-10,0,1,0,0,1593
151,151,2012-01-13,0,0,1,-1,1592
152,152,2012-01-14,2,3,2,2,1594
153,153,2012-01-26,5,7,4,-8,1586
154,154,2012-01-31,24,26,24,21,1607
155,155,2012-02-13,0,0,1,-1,1606
156,156,2012-02-26,5,7,5,-3,1603
157,157,2012-02-28,9,11,8,8,1611
158,158,2012-02-29,7,9,7,-13,1598
159,159,2012-03-03,3,3,4,0,1598
160,160,2012-03-06,10,11,10,20,1618
161,161,2012-03-15,1,2,1,-2,1616
162,162,2012-03-21,6,6,7,-14,1602
163,163,2012-03-26,1,2,1,-2,1600
164,164,2012-03-31,4,5,4,-4,1596
165,165,2012-04-01,12,14,11,11,1607
166,166,2012-04-03,29,31,28,-56,1551
167,167,2012-04-05,7,8,7,14,1565
168,168,2012-04-09,28,30,27,-54,1511
169,169,2012-04-13,32,36,29,-58,1453
170,170,2012-04-16,27,41,21,-9,1444
171,171,2012-04-20,7,8,7,14,1458
172,172,2012-04-24,51,53,51,30,1488
173,173,2012-04-25,6,6,7,14,1502
174,174,2012-04-29,9,12,7,7,1509
175,175,2012-04-30,26,30,23,23,1532
176,176,2012-05-05,9,11,9,-11,1521
177,177,2012-05-06,12,16,9,-18,1503
178,178,2012-05-10,20,23,18,-36,1467
179,179,2012-05-18,9,11,9,18,1485
180,180,2012-05-21,2,2,3,6,1491
181,181,2012-05-22,20,20,21,42,1533
182,182,2012-05-24,13,15,12,-24,1509
183,183,2012-06-04,3,3,4,4,1513
184,184,2012-06-05,0,1,0,0,1513
185,185,2012-06-07,8,8,9,9,1522
186,186,2012-06-09,52,56,49,98,1620
187,187,2012-06-12,55,84,30,-60,1560
188,188,2012-06-18,44,52,38,10,1570
189,189,2012-06-19,10,12,9,-18,1552
190,190,2012-06-22,6,8,6,12,1564
191,191,2012-06-25,3,3,4,-8,1556
192,192,2012-06-27,4,4,5,-10,1546
193,193,2012-07-10,5,5,7,-6,1540
194,194,2012-07-13,4,7,2,-4,1536
195,195,2012-07-21,9,9,10,20,1556
196,196,2012-07-30,2,2,3,6,1562
197,197,2012-07-31,1,2,1,-2,1560
198,198,2012-08-01,5,14,-3,6,1566
199,199,2012-08-06,4,6,4,2,1568
200,200,2012-08-08,8,9,11,-1,1567
201,201,2012-08-09,6,10,4,-6,1561
202,202,2012-08-21,14,18,13,-14,1547
203,203,2012-08-25,11,13,10,20,1567
204,204,2012-08-29,10,10,12,-8,1559
205,205,2012-08-30,49,49,50,-100,1459
206,206,2012-09-01,1,1,2,4,1463
207,207,2012-09-05,0,0,1,-2,1461
208,208,2012-09-06,14,19,10,0,1461
209,209,2012-09-10,24,24,25,-50,1411
210,210,2012-09-11,7,8,8,-8,1403
211,211,2012-09-14,3,4,3,6,1409
212,212,2012-09-17,3,3,4,8,1417
213,213,2012-09-19,10,15,7,2,1419
214,214,2012-09-21,14,19,10,0,1419
215,215,2012-09-27,0,0,1,1,1420
216,216,2012-10-07,18,20,17,34,1454
217,217,2012-10-08,17,18,18,36,1490
218,218,2012-10-14,13,17,10,0,1490
219,219,2012-10-17,9,10,9,-18,1472
220,220,2012-10-18,0,0,1,-1,1471
221,221,2012-10-19,2,2,3,-6,1465
222,222,2012-10-20,1,1,2,4,1469
223,223,2012-10-22,7,8,8,-16,1453
224,224,2012-10-30,13,14,13,13,1466
225,225,2012-11-04,44,48,41,41,1507
226,226,2012-11-05,1,2,1,2,1509
227,227,2012-11-07,15,17,14,28,1537
228,228,2012-11-08,5,6,5,-10,1527
229,229,2012-11-09,6,11,6,4,1531
230,230,2012-11-11,12,14,12,-4,1527
231,231,2012-11-12,2,3,2,-4,1523
232,232,2012-11-13,2,3,2,2,1525
233,233,2012-11-14,6,6,7,-14,1511
234,234,2012-11-16,3,3,4,8,1519
235,235,2012-11-17,8,27,-10,20,1539
236,236,2012-11-21,0,0,1,-2,1537
237,237,2012-11-24,2,3,2,-2,1535
238,238,2012-11-26,0,0,2,0,1535
239,239,2012-11-27,4,21,-11,-1,1534
240,240,2012-12-03,2,2,3,-3,1531
241,241,2012-12-04,7,9,6,-12,1519
242,242,2012-12-07,3,3,4,8,1527
243,243,2012-12-10,6,6,9,18,1545
244,244,2012-12-13,0,0,1,-2,1543
245,245,2012-12-16,0,1,0,0,1543
246,246,2012-12-20,1,1,2,-4,1539
247,247,2012-12-21,32,38,30,38,1577
248,248,2012-12-24,5,6,5,10,1587
249,249,2012-12-26,1,2,2,0,1587
250,250,2012-12-27,1,2,1,2,1589
251,251,2012-12-28,9,9,10,-20,1569
252,252,2012-12-30,6,6,7,7,1576
253,253,2013-01-01,16,19,15,-30,1546
254,254,2013-01-03,2,3,3,3,1549
255,255,2013-01-06,3,3,5,10,1559
256,256,2013-01-07,5,5,7,12,1571
257,257,2013-01-14,4,9,1,5,1576
258,258,2013-01-15,0,3,-1,0,1576
259,259,2013-01-19,1,2,1,-2,1574
260,260,2013-01-20,1,1,2,-4,1570
261,261,2013-01-22,6,7,6,6,1576
262,262,2013-01-24,5,6,5,-10,1566
263,263,2013-01-30,1,1,2,4,1570
264,264,2013-01-31,3,8,-1,0,1570
265,265,2013-02-01,3,3,4,-8,1562
266,266,2013-02-02,3,3,4,-8,1554
267,267,2013-02-07,4,5,4,4,1558
268,268,2013-02-08,1,2,4,-2,1556
269,269,2013-02-09,7,9,7,7,1563
270,270,2013-02-11,25,30,23,-14,1549
271,271,2013-02-12,2,3,2,-4,1545
272,272,2013-02-13,0,0,1,2,1547
273,273,2013-02-16,0,0,1,-2,1545
274,274,2013-02-17,9,10,10,-1,1544
275,275,2013-02-20,93,100,88,4,1548
276,276,2013-02-21,0,0,1,1,1549
277,277,2013-02-23,2,3,3,0,1549
278,278,2013-02-26,4,7,4,-5,1544
279,279,2013-02-27,7,7,9,11,1555
280,280,2013-02-28,0,0,1,2,1557
281,281,2013-03-02,7,7,8,0,1557
282,282,2013-03-03,2,4,1,-2,1555
283,283,2013-03-06,3,3,4,-4,1551
284,284,2013-03-07,4,4,5,-5,1546
285,285,2013-03-08,1,1,2,-4,1542
286,286,2013-03-11,3,3,4,0,1542
287,287,2013-03-14,8,10,7,14,1556
288,288,2013-03-16,6,6,7,-14,1542
289,289,2013-03-19,4,7,3,2,1544
290,290,2013-03-20,0,0,1,1,1545
291,291,2013-03-25,66,68,66,132,1677
292,292,2013-03-29,1,1,2,4,1681
293,293,2013-03-31,2,2,3,6,1687
294,294,2013-04-03,1,1,2,4,1691
295,295,2013-04-04,1,1,2,-4,1687
296,296,2013-04-05,0,0,1,1,1688
297,297,2013-04-07,5,5,7,-2,1686
298,298,2013-04-08,20,36,7,-14,1672
299,299,2013-04-09,36,43,31,18,1690
300,300,2013-04-13,0,3,-2,-4,1686
301,301,2013-04-15,10,13,8,8,1694
302,302,2013-04-17,6,12,1,-2,1692
303,303,2013-04-18,3,3,4,8,1700
304,304,2013-04-20,10,11,12,3,1703
305,305,2013-04-21,5,10,2,0,1703
306,306,2013-04-22,1,1,2,-4,1699
307,307,2013-04-25,1,1,2,-4,1695
308,308,2013-04-27,1,1,2,4,1699
309,309,2013-04-29,54,55,54,108,1807
310,310,2013-04-30,1,1,2,0,1807
311,311,2013-05-01,4,4,5,10,1817
312,312,2013-05-04,3,11,-4,-8,1809
313,313,2013-05-05,2,2,3,-6,1803
314,314,2013-05-06,4,4,5,10,1813
315,315,2013-05-08,6,6,7,14,1827
316,316,2013-05-09,12,13,15,30,1857
317,317,2013-05-10,34,39,30,-60,1797
318,318,2013-05-11,4,5,5,10,1807
319,319,2013-05-14,0,1,0,0,1807
320,320,2013-05-15,28,30,27,0,1807
321,321,2013-05-22,1,1,2,4,1811
322,322,2013-05-24,10,10,11,-22,1789
323,323,2013-05-26,6,8,5,5,1794
324,324,2013-05-29,0,1,0,0,1794
325,325,2013-06-01,28,29,29,-55,1739
326,326,2013-06-02,2,2,3,6,1745
327,327,2013-06-04,3,3,4,0,1745
328,328,2013-06-07,7,9,7,2,1747
329,329,2013-06-09,1,1,2,-4,1743
330,330,2013-06-12,4,4,5,10,1753
331,331,2013-06-14,1,1,2,4,1757
332,332,2013-06-15,9,15,4,-8,1749
333,333,2013-06-16,5,6,7,-10,1739
334,334,2013-06-17,2,4,1,-2,1737
335,335,2013-06-18,1,1,2,0,1737
336,336,2013-06-21,1,1,2,4,1741
337,337,2013-06-24,5,5,6,12,1753
338,338,2013-06-26,9,11,11,12,1765
339,339,2013-06-27,71,75,68,68,1833
340,340,2013-06-30,1,1,2,-4,1829
341,341,2013-07-01,8,10,7,-14,1815
342,342,2013-07-03,116,122,111,222,2037
343,343,2013-07-05,1,2,1,2,2039
344,344,2013-07-06,20,21,21,-30,2009
345,345,2013-07-09,6,6,7,14,2023
346,346,2013-07-14,0,0,1,1,2024
347,347,2013-07-17,0,0,1,2,2026
348,348,2013-07-18,2,2,3,6,2032
349,349,2013-07-19,2,2,3,-6,2026
350,350,2013-07-21,0,1,1,2,2028
351,351,2013-07-22,25,28,23,-46,1982
352,352,2013-07-24,0,0,1,-2,1980
353,353,2013-07-25,3,4,4,-8,1972
354,354,2013-07-28,2,5,1,2,1974
355,355,2013-07-29,27,31,24,24,1998
356,356,2013-07-31,1,1,2,-4,1994
357,357,2013-08-01,0,0,1,-2,1992
358,358,2013-08-02,2,2,3,6,1998
359,359,2013-08-04,1,1,2,4,2002
360,360,2013-08-07,0,0,1,-1,2001
361,361,2013-08-10,8,9,9,11,2012
362,362,2013-08-11,2,2,3,6,2018
363,363,2013-08-12,9,10,10,-20,1998
364,364,2013-08-15,2,2,4,-1,1997
365,365,2013-08-16,0,0,1,-2,1995
366,366,2013-08-23,3,5,2,2,1997
367,367,2013-08-25,63,69,58,-116,1881
368,368,2013-08-29,2,3,2,2,1883
369,369,2013-08-31,28,30,28,47,1930
370,370,2013-09-02,2,4,1,-1,1929
371,371,2013-09-04,1,1,2,4,1933
372,372,2013-09-05,5,9,3,-6,1927
373,373,2013-09-06,2,2,4,8,1935
374,374,2013-09-08,2,2,3,0,1935
375,375,2013-09-09,2,2,3,-6,1929
376,376,2013-09-10,6,9,4,-4,1925
377,377,2013-09-11,0,0,1,2,1927
378,378,2013-09-12,3,4,4,-8,1919
379,379,2013-09-13,28,32,26,52,1971
380,380,2013-09-14,1,1,2,4,1975
381,381,2013-09-16,2,2,4,0,1975
382,382,2013-09-17,8,10,8,2,1977
383,383,2013-09-18,32,32,34,65,2042
384,384,2013-09-19,2,3,3,4,2046
385,385,2013-09-20,4,4,5,-10,2036
386,386,2013-09-21,3,4,4,8,2044
387,387,2013-09-22,0,0,2,0,2044
388,388,2013-09-24,2,3,2,-4,2040
389,389,2013-09-25,1,1,2,2,2042
390,390,2013-10-01,2,2,4,4,2046
391,391,2013-10-02,1,1,3,2,2048
392,392,2013-10-04,8,9,9,-6,2042
393,393,2013-10-05,41,42,42,-84,1958
394,394,2013-10-06,29,36,24,-48,1910
395,395,2013-10-07,12,14,11,-22,1888
396,396,2013-10-08,0,0,1,0,1888
397,397,2013-10-10,2,12,-7,14,1902
398,398,2013-10-11,2,2,3,-6,1896
399,399,2013-10-12,4,5,5,6,1902
400,400,2013-10-16,1,2,1,-1,1901
401,401,2013-10-23,2,2,3,-6,1895
402,402,2013-10-24,2,3,2,-4,1891
403,403,2013-10-25,2,3,3,6,1897
404,404,2013-10-28,10,19,4,5,1902
405,405,2013-10-29,1,1,2,2,1904
406,406,2013-11-01,2,3,3,0,1904
407,407,2013-11-02,0,0,1,2,1906
408,408,2013-11-03,0,0,1,2,1908
409,409,2013-11-05,4,4,5,-5,1903
410,410,2013-11-11,1,2,1,1,1904
411,411,2013-11-13,7,10,7,6,1910
412,412,2013-11-14,5,6,6,8,1918
413,413,2013-11-15,0,0,1,-2,1916
414,414,2013-11-17,23,25,23,18,1934
415,415,2013-11-19,21,28,18,-20,1914
416,416,2013-11-20,1,1,2,4,1918
417,417,2013-11-21,1,7,-4,8,1926
418,418,2013-11-22,1,1,2,-4,1922
419,419,2013-11-23,0,0,1,2,1924
420,420,2013-11-24,10,11,11,-8,1916
421,421,2013-11-25,4,4,6,12,1928
422,422,2013-11-26,1,1,2,4,1932
423,423,2013-11-27,3,3,4,-8,1924
424,424,2013-11-29,3,5,4,2,1926
425,425,2013-11-30,2,2,3,-6,1920
426,426,2013-12-01,1,4,-1,1,1921
427,427,2013-12-03,2,2,3,-6,1915
428,428,2013-12-04,0,0,1,2,1917
429,429,2013-12-05,1,1,2,4,1921
430,430,2013-12-06,0,0,1,2,1923
431,431,2013-12-07,0,0,1,2,1925
432,432,2013-12-09,1,2,2,0,1925
433,433,2013-12-11,0,0,1,-2,1923
434,434,2013-12-12,3,5,3,-6,1917
435,435,2013-12-13,1,2,1,2,1919
436,436,2013-12-14,0,1,0,0,1919
437,437,2013-12-17,1,1,3,2,1921
438,438,2013-12-18,9,9,11,16,1937
439,439,2013-12-20,0,1,0,0,1937
440,440,2013-12-21,3,3,5,-10,1927
441,441,2013-12-23,1,1,2,2,1929
442,442,2013-12-24,1,1,2,0,1929
443,443,2013-12-26,4,5,7,9,1938
444,444,2013-12-27,2,3,2,4,1942
445,445,2013-12-28,10,15,7,7,1949
446,446,2014-01-01,6,6,9,-10,1939
447,447,2014-01-02,5,5,6,-12,1927
448,448,2014-01-03,6,8,6,6,1933
449,449,2014-01-04,8,12,6,-12,1921
450,450,2014-01-06,121,133,110,110,2031
451,451,2014-01-07,4,4,5,5,2036
452,452,2014-01-08,12,13,15,-8,2028
453,453,2014-01-09,2,2,4,5,2033
454,454,2014-01-11,2,2,4,-8,2025
455,455,2014-01-12,3,3,4,8,2033
456,456,2014-01-13,11,14,10,-3,2030
457,457,2014-01-14,21,25,19,37,2067
458,458,2014-01-15,2,3,3,6,2073
459,459,2014-01-16,13,14,15,-26,2047
460,460,2014-01-17,3,3,4,-8,2039
461,461,2014-01-19,15,17,16,32,2071
462,462,2014-01-21,6,7,8,4,2075
463,463,2014-01-23,6,8,8,4,2079
464,464,2014-01-25,1,1,2,-4,2075
465,465,2014-01-28,1,1,2,2,2077
466,466,2014-01-29,3,3,6,2,2079
467,467,2014-02-04,1,1,2,-4,2075
468,468,2014-02-05,2,2,3,6,2081
469,469,2014-02-08,3,5,4,-3,2078
470,470,2014-02-09,2,3,2,0,2078
471,471,2014-02-10,3,3,4,-8,2070
472,472,2014-02-11,2,2,3,6,2076
473,473,2014-02-12,3,3,4,8,2084
474,474,2014-02-13,61,71,52,52,2136
475,475,2014-02-14,4,7,2,-4,2132
476,476,2014-02-15,1,2,1,2,2134
477,477,2014-02-16,1,2,2,-4,2130
478,478,2014-02-19,4,4,5,-5,2125
479,479,2014-02-20,2,2,3,6,2131
480,480,2014-02-21,3,4,5,0,2131
481,481,2014-02-22,0,0,1,1,2132
482,482,2014-02-24,0,0,1,2,2134
483,483,2014-02-25,11,12,12,-9,2125
484,484,2014-02-26,0,0,1,-2,2123
485,485,2014-02-27,1,1,2,-4,2119
486,486,2014-02-28,4,5,4,0,2119
487,487,2014-03-01,0,6,-3,14,2133
488,488,2014-03-04,13,17,12,1,2134
489,489,2014-03-05,1,1,2,0,2134
490,490,2014-03-06,345,376,317,631,2765
491,491,2014-03-07,4,4,7,2,2767
492,492,2014-03-08,6,9,4,8,2775
493,493,2014-03-09,3,3,4,-8,2767
494,494,2014-03-10,0,0,1,-2,2765
495,495,2014-03-11,2,3,4,1,2766
496,496,2014-03-13,3,4,4,0,2766
497,497,2014-03-14,3,3,4,-8,2758
498,498,2014-03-15,95,107,86,168,2926
499,499,2014-03-16,6,8,6,6,2932
500,500,2014-03-17,3,3,5,-6,2926
501,501,2014-03-18,3,3,4,8,2934
502,502,2014-03-19,11,14,10,-16,2918
503,503,2014-03-20,18,18,20,40,2958
504,504,2014-03-22,1,2,2,4,2962
505,505,2014-03-24,1,2,2,0,2962
506,506,2014-03-25,0,4,-3,-3,2959
507,507,2014-03-26,0,0,2,4,2963
508,508,2014-03-29,2,6,1,0,2963
509,509,2014-03-30,0,0,1,2,2965
510,510,2014-04-01,3,3,4,4,2969
511,511,2014-04-03,6,7,7,14,2983
512,512,2014-04-04,0,0,1,2,2985
513,513,2014-04-05,1,3,1,-2,2983
514,514,2014-04-06,10,12,9,9,2992
515,515,2014-04-07,17,19,16,16,3008
516,516,2014-04-08,8,8,10,20,3028
517,517,2014-04-11,10,10,11,-11,3017
518,518,2014-04-12,97,112,85,169,3186
519,519,2014-04-13,7,9,8,13,3199
520,520,2014-04-14,2,3,3,6,3205
521,521,2014-04-15,0,0,3,0,3205
522,522,2014-04-17,0,0,1,2,3207
523,523,2014-04-18,2,4,1,-2,3205
524,524,2014-04-19,4,7,4,8,3213
525,525,2014-04-21,0,1,0,0,3213
526,526,2014-04-24,0,0,1,2,3215
527,527,2014-04-25,5,7,4,-8,3207
528,528,2014-04-26,0,1,0,0,3207
529,529,2014-04-29,2,2,3,-6,3201
530,530,2014-04-30,1,2,1,0,3201
531,531,2014-05-01,0,0,1,-2,3199
532,532,2014-05-03,5,7,5,5,3204
533,533,2014-05-05,0,0,1,1,3205
534,534,2014-05-09,0,0,1,2,3207
535,535,2014-05-12,1,1,3,0,3207
536,536,2014-05-19,1,2,1,-1,3206
537,537,2014-05-22,0,0,1,0,3206
538,538,2014-05-23,141,154,130,106,3312
539,539,2014-05-24,0,0,2,4,3316
540,540,2014-05-25,1,7,-3,-6,3310
541,541,2014-05-27,2,3,3,-6,3304
542,542,2014-05-29,6,8,5,5,3309
543,543,2014-05-30,8,10,8,11,3320
544,544,2014-06-01,0,0,2,4,3324
545,545,2014-06-02,13,21,7,-14,3310
546,546,2014-06-03,5,8,4,-12,3298
547,547,2014-06-05,72,81,69,-6,3292
548,548,2014-06-06,15,18,13,-26,3266
549,549,2014-06-07,4,5,6,0,3266
550,550,2014-06-10,0,0,1,1,3267
551,551,2014-06-11,21,23,21,-22,3245
552,552,2014-06-14,0,0,1,1,3246
553,553,2014-06-16,4,4,7,-9,3237
554,554,2014-06-17,3,4,5,-2,3235
555,555,2014-06-18,2,2,3,3,3238
556,556,2014-06-20,0,0,1,2,3240
557,557,2014-06-21,3,8,0,6,3246
558,558,2014-06-22,5,6,6,-9,3237
559,559,2014-06-24,0,2,0,2,3239
560,560,2014-06-25,1,2,1,2,3241
561,561,2014-06-27,1,3,0,0,3241
562,562,2014-06-28,4,5,4,8,3249
563,563,2014-06-30,13,17,11,-14,3235
564,564,2014-07-01,4,5,4,4,3239
565,565,2014-07-02,2,2,3,6,3245
566,566,2014-07-04,7,18,-1,34,3279
567,567,2014-07-05,6,6,7,14,3293
568,568,2014-07-08,1,1,3,6,3299
569,569,2014-07-09,6,8,6,-12,3287
570,570,2014-07-10,7,11,6,3,3290
571,571,2014-07-11,0,2,-1,1,3291
572,572,2014-07-13,6,7,7,7,3298
573,573,2014-07-14,7,8,12,23,3321
574,574,2014-07-15,2,7,-2,4,3325
575,575,2014-07-17,0,0,2,0,3325
576,576,2014-07-18,0,1,0,0,3325
577,577,2014-07-21,2,3,3,-5,3320
578,578,2014-07-22,0,3,0,-1,3319
579,579,2014-07-23,1,1,2,2,3321
580,580,2014-07-25,7,9,10,6,3327
581,581,2014-07-28,9,9,11,-22,3305
582,582,2014-07-30,3,3,5,2,3307
583,583,2014-07-31,3,11,-3,-6,3301
584,584,2014-08-01,2,4,2,2,3303
585,585,2014-08-02,5,7,5,2,3305
586,586,2014-08-03,5,6,8,16,3321
587,587,2014-08-04,0,0,1,1,3322
588,588,2014-08-06,1,1,2,2,3324
589,589,2014-08-08,0,1,0,0,3324
590,590,2014-08-09,1,2,1,2,3326
591,591,2014-08-12,1,1,2,4,3330
592,592,2014-08-13,4,5,5,10,3340
593,593,2014-08-14,10,12,9,-18,3322
594,594,2014-08-15,0,1,0,0,3322
595,595,2014-08-16,1,2,1,2,3324
596,596,2014-08-17,0,0,2,3,3327
597,597,2014-08-18,6,6,9,-18,3309
598,598,2014-08-19,1,2,3,4,3313
599,599,2014-08-20,0,3,-1,-2,3311
600,600,2014-08-22,0,0,1,2,3313
601,601,2014-08-24,3,6,3,8,3321
602,602,2014-08-25,0,0,1,2,3323
603,603,2014-08-26,4,5,4,-8,3315
604,604,2014-08-27,0,1,0,0,3315
605,605,2014-08-28,0,2,0,2,3317
606,606,2014-08-29,11,13,10,-20,3297
607,607,2014-08-30,2,2,4,4,3301
608,608,2014-08-31,1,2,1,1,3302
609,609,2014-09-02,7,8,9,-7,3295
610,610,2014-09-03,14,20,10,-16,3279
611,611,2014-09-04,1,1,3,6,3285
612,612,2014-09-05,0,0,1,-2,3283
613,613,2014-09-06,1,1,2,4,3287
614,614,2014-09-07,8,9,9,-18,3269
615,615,2014-09-08,24,26,25,-47,3222
616,616,2014-09-10,0,0,1,2,3224
617,617,2014-09-11,4,4,6,3,3227
618,618,2014-09-12,0,1,2,3,3230
619,619,2014-09-13,0,0,1,2,3232
620,620,2014-09-14,9,10,9,-18,3214
621,621,2014-09-15,0,1,0,0,3214
622,622,2014-09-16,2,2,3,6,3220
623,623,2014-09-19,46,47,47,90,3310
624,624,2014-09-20,0,0,2,3,3313
625,625,2014-09-21,6,12,2,1,3314
626,626,2014-09-23,2,3,3,6,3320
627,627,2014-09-26,0,0,1,2,3322
628,628,2014-09-27,7,8,8,-16,3306
629,629,2014-09-28,3,4,4,-1,3305
630,630,2014-09-29,0,1,1,2,3307
631,631,2014-10-01,12,17,12,-14,3293
632,632,2014-10-02,2,6,1,8,3301
633,633,2014-10-03,13,20,10,-20,3281
634,634,2014-10-04,5,7,5,-10,3271
635,635,2014-10-06,0,1,1,2,3273
636,636,2014-10-07,0,4,-3,-3,3270
637,637,2014-10-08,0,0,2,1,3271
638,638,2014-10-13,16,22,14,-6,3265
639,639,2014-10-15,2,3,2,-2,3263
640,640,2014-10-17,0,0,1,2,3265
641,641,2014-10-18,30,34,29,45,3310
642,642,2014-10-21,0,0,1,2,3312
643,643,2014-10-23,0,1,1,1,3313
644,644,2014-10-25,0,0,1,-2,3311
645,645,2014-10-26,0,0,1,1,3312
646,646,2014-10-27,0,0,2,4,3316
647,647,2014-10-28,0,0,1,2,3318
648,648,2014-10-31,1,1,2,2,3320
649,649,2014-11-01,0,0,1,2,3322
650,650,2014-11-03,39,47,36,-68,3254
651,651,2014-11-04,14,16,13,-26,3228
652,652,2014-11-06,0,0,1,2,3230
653,653,2014-11-07,1,1,2,2,3232
654,654,2014-11-08,0,0,1,-2,3230
655,655,2014-11-09,2,2,4,5,3235
656,656,2014-11-11,2,5,3,8,3243
657,657,2014-11-12,0,0,2,2,3245
658,658,2014-11-13,0,0,1,2,3247
659,659,2014-11-14,8,11,6,-12,3235
660,660,2014-11-15,0,0,1,-2,3233
661,661,2014-11-16,0,0,2,4,3237
662,662,2014-11-17,9,9,11,-18,3219
663,663,2014-11-19,3,3,4,-8,3211
664,664,2014-11-20,7,9,7,14,3225
665,665,2014-11-21,6,7,9,14,3239
666,666,2014-11-22,0,0,1,2,3241
667,667,2014-11-23,2,3,3,4,3245
668,668,2014-11-24,1,2,1,2,3247
669,669,2014-11-25,0,1,2,3,3250
670,670,2014-11-26,21,21,25,-35,3215
671,671,2014-11-27,2,2,3,6,3221
672,672,2014-11-29,0,0,3,5,3226
673,673,2014-11-30,7,10,5,10,3236
674,674,2014-12-01,0,0,2,3,3239
675,675,2014-12-02,1,1,2,0,3239
676,676,2014-12-04,20,28,16,8,3247
677,677,2014-12-05,1,1,2,4,3251
678,678,2014-12-06,5,6,7,4,3255
679,679,2014-12-08,3,3,8,11,3266
680,680,2014-12-09,29,33,28,-46,3220
681,681,2014-12-10,0,1,0,0,3220
682,682,2014-12-11,3,5,6,3,3223
683,683,2014-12-14,3,3,4,8,3231
684,684,2014-12-18,4,40,-27,77,3308
685,685,2014-12-19,0,0,1,2,3310
686,686,2014-12-20,0,0,1,1,3311
687,687,2014-12-21,6,7,6,-12,3299
688,688,2014-12-22,3,5,4,4,3303
689,689,2014-12-23,1,2,4,-3,3300
690,690,2014-12-25,1,2,1,0,3300
691,691,2014-12-26,4,5,6,8,3308
692,692,2014-12-27,0,0,1,2,3310
693,693,2014-12-28,3,4,4,4,3314
694,694,2014-12-29,1,1,4,-2,3312
695,695,2014-12-30,1,1,2,2,3314
696,696,2014-12-31,2,3,4,8,3322
697,697,2015-01-01,120,132,115,229,3551
698,698,2015-01-02,0,1,0,0,3551
699,699,2015-01-03,4,7,5,2,3553
700,700,2015-01-05,2,6,3,5,3558
701,701,2015-01-06,2,3,2,-2,3556
702,702,2015-01-07,2,2,3,6,3562
703,703,2015-01-08,189,202,180,2,3564
704,704,2015-01-09,0,5,1,3,3567
705,705,2015-01-10,0,1,0,0,3567
706,706,2015-01-11,3,7,0,0,3567
707,707,2015-01-12,109,122,98,196,3763
708,708,2015-01-13,63,69,60,-113,3650
709,709,2015-01-14,0,0,1,2,3652
710,710,2015-01-16,7,7,9,12,3664
711,711,2015-01-18,0,0,1,2,3666
712,712,2015-01-19,814,848,781,1562,5228
713,713,2015-01-20,1,2,2,4,5232
714,714,2015-01-21,2,3,4,0,5232
715,715,2015-01-22,1,1,6,6,5238
716,716,2015-01-23,4,13,-1,-13,5225
717,717,2015-01-24,1,4,0,2,5227
718,718,2015-01-25,7,15,3,-14,5213
719,719,2015-01-26,6,6,10,-8,5205
720,720,2015-01-27,7,9,7,7,5212
721,721,2015-01-28,8,14,5,7,5219
722,722,2015-01-29,6,7,6,6,5225
723,723,2015-01-30,2,4,3,10,5235
724,724,2015-01-31,2,7,0,-5,5230
725,725,2015-02-02,20,30,16,20,5250
726,726,2015-02-03,3,6,2,2,5252
727,727,2015-02-04,6,23,-7,34,5286
728,728,2015-02-05,2,6,1,-9,5277
729,729,2015-02-06,5,6,6,-4,5273
730,730,2015-02-07,1,3,0,0,5273
731,731,2015-02-08,4,14,-3,12,5285
732,732,2015-02-09,0,0,2,4,5289
733,733,2015-02-10,1,2,1,0,5289
734,734,2015-02-11,1,1,3,5,5294
735,735,2015-02-13,2,2,3,-6,5288
736,736,2015-02-15,1,1,3,-2,5286
737,737,2015-02-16,1,3,2,4,5290
738,738,2015-02-17,2,2,5,-2,5288
739,739,2015-02-18,0,1,2,0,5288
740,740,2015-02-19,1,1,3,5,5293
741,741,2015-02-20,1,2,3,6,5299
742,742,2015-02-21,3,3,4,8,5307
743,743,2015-02-22,3,3,7,-2,5305
744,744,2015-02-23,9,12,13,-6,5299
745,745,2015-02-25,4,5,8,11,5310
746,746,2015-02-26,5,8,6,-2,5308
747,747,2015-02-27,0,0,2,2,5310
748,748,2015-02-28,5,5,11,4,5314
749,749,2015-03-01,7,10,5,-10,5304
750,750,2015-03-02,0,0,1,0,5304
751,751,2015-03-03,2,5,5,4,5308
752,752,2015-03-04,3,3,5,-2,5306
753,753,2015-03-05,4,5,6,1,5307
754,754,2015-03-06,2,5,3,2,5309
755,755,2015-03-07,1,6,0,0,5309
756,756,2015-03-08,0,0,3,1,5310
757,757,2015-03-09,0,6,-1,10,5320
758,758,2015-03-10,2,9,-2,0,5320
759,759,2015-03-11,2,2,3,-6,5314
760,760,2015-03-12,1,1,3,0,5314
761,761,2015-03-13,14,18,12,-21,5293
762,762,2015-03-14,1,1,2,-4,5289
763,763,2015-03-15,4,5,8,-4,5285
764,764,2015-03-16,3,6,5,-1,5284
765,765,2015-03-17,6,7,6,-12,5272
766,766,2015-03-18,1,1,2,4,5276
767,767,2015-03-21,0,0,2,0,5276
768,768,2015-03-22,0,0,2,3,5279
769,769,2015-03-23,1,1,4,6,5285
770,770,2015-03-24,1,26,-22,48,5333
771,771,2015-03-25,0,1,0,0,5333
772,772,2015-03-26,2,2,5,8,5341
773,773,2015-03-29,0,0,1,-2,5339
774,774,2015-03-31,0,1,1,-2,5337
775,775,2015-04-02,1,2,5,6,5343
776,776,2015-04-03,0,0,1,2,5345
777,777,2015-04-04,0,0,1,2,5347
778,778,2015-04-05,0,0,2,4,5351
779,779,2015-04-06,0,0,1,2,5353
780,780,2015-04-07,25,37,16,-28,5325
781,781,2015-04-08,0,0,2,4,5329
782,782,2015-04-09,0,0,1,1,5330
783,783,2015-04-10,2,2,4,7,5337
784,784,2015-04-11,2,2,3,6,5343
785,785,2015-04-13,0,0,5,8,5351
786,786,2015-04-14,2,3,3,-2,5349
787,787,2015-04-15,0,3,-2,4,5353
788,788,2015-04-16,1,2,7,-2,5351
789,789,2015-04-18,1,3,1,2,5353
790,790,2015-04-19,8,8,10,20,5373
791,791,2015-04-21,25,26,28,-18,5355
792,792,2015-04-22,1,2,2,0,5355
793,793,2015-04-23,6,7,8,-12,5343
794,794,2015-04-25,1,1,2,2,5345
795,795,2015-04-26,0,0,3,-1,5344
796,796,2015-04-27,6,9,7,-4,5340
797,797,2015-04-28,1,6,-1,9,5349
798,798,2015-04-30,7,7,8,8,5357
799,799,2015-05-01,1,1,2,4,5361
800,800,2015-05-02,2,3,2,2,5363
801,801,2015-05-03,4,4,8,15,5378
802,802,2015-05-05,0,0,1,2,5380
803,803,2015-05-06,0,1,1,0,5380
804,804,2015-05-07,0,1,2,2,5382
805,805,2015-05-08,6,10,6,10,5392
806,806,2015-05-09,1,2,1,-2,5390
807,807,2015-05-11,3,3,6,8,5398
808,808,2015-05-13,3,5,3,0,5398
809,809,2015-05-15,1,1,2,0,5398
810,810,2015-05-16,5,6,7,-4,5394
811,811,2015-05-17,0,0,3,4,5398
812,812,2015-05-19,0,0,4,4,5402
813,813,2015-05-20,4,5,4,4,5406
814,814,2015-05-22,2,2,3,-3,5403
815,815,2015-05-23,0,0,1,-1,5402
816,816,2015-05-24,0,0,2,4,5406
817,817,2015-05-25,97,108,89,3,5409
818,818,2015-05-26,0,0,3,5,5414
819,819,2015-05-27,3,4,4,4,5418
820,820,2015-05-28,0,0,1,2,5420
821,821,2015-05-30,6,7,11,17,5437
822,822,2015-05-31,0,0,1,1,5438
823,823,2015-06-01,12,13,14,-23,5415
824,824,2015-06-02,0,0,1,2,5417
825,825,2015-06-03,11,11,17,-15,5402
826,826,2015-06-04,0,0,1,1,5403
827,827,2015-06-05,3,3,7,12,5415
828,828,2015-06-06,2,2,4,5,5420
829,829,2015-06-07,3,3,5,-6,5414
830,830,2015-06-08,0,1,0,0,5414
831,831,2015-06-09,1,2,4,3,5417
832,832,2015-06-10,0,0,2,-1,5416
833,833,2015-06-11,1,3,1,2,5418
834,834,2015-06-14,1,1,5,8,5426
835,835,2015-06-15,1,3,2,0,5426
836,836,2015-06-16,8,9,9,-18,5408
837,837,2015-06-17,0,0,2,-3,5405
838,838,2015-06-18,6,13,3,8,5413
839,839,2015-06-19,2,3,2,2,5415
840,840,2015-06-20,0,0,1,1,5416
841,841,2015-06-21,0,0,1,1,5417
842,842,2015-06-22,0,0,2,4,5421
843,843,2015-06-23,0,0,2,0,5421
844,844,2015-06-24,2,2,5,10,5431
845,845,2015-06-25,1,1,2,4,5435
846,846,2015-06-26,0,1,2,0,5435
847,847,2015-06-27,3,4,4,7,5442
848,848,2015-06-28,0,0,1,2,5444
849,849,2015-06-29,1,1,2,2,5446
850,850,2015-07-01,0,1,1,1,5447
851,851,2015-07-02,4,5,4,-8,5439
852,852,2015-07-03,1,3,2,0,5439
853,853,2015-07-04,5,11,2,-4,5435
854,854,2015-07-05,51,56,50,97,5532
855,855,2015-07-06,6,10,5,11,5543
856,856,2015-07-07,4,5,6,-5,5538
857,857,2015-07-08,0,1,0,0,5538
858,858,2015-07-09,0,0,3,0,5538
859,859,2015-07-11,1,1,2,0,5538
860,860,2015-07-14,1,4,1,5,5543
861,861,2015-07-15,0,5,-4,4,5547
862,862,2015-07-16,0,0,2,3,5550
863,863,2015-07-17,7,12,6,12,5562
864,864,2015-07-18,1,1,3,-3,5559
865,865,2015-07-19,0,0,1,1,5560
866,866,2015-07-21,0,0,6,5,5565
867,867,2015-07-22,0,0,1,2,5567
868,868,2015-07-23,0,0,5,7,5574
869,869,2015-07-24,0,0,5,7,5581
870,870,2015-07-25,13,14,17,20,5601
871,871,2015-07-26,4,4,6,-3,5598
872,872,2015-07-27,12,16,12,9,5607
873,873,2015-07-28,3,3,5,6,5613
874,874,2015-07-30,0,0,2,2,5615
875,875,2015-07-31,0,1,2,0,5615
876,876,2015-08-01,2,2,7,13,5628
877,877,2015-08-02,21,22,23,-18,5610
878,878,2015-08-03,0,1,0,0,5610
879,879,2015-08-04,4,6,7,2,5612
880,880,2015-08-05,4,4,7,10,5622
881,881,2015-08-06,0,0,2,4,5626
882,882,2015-08-07,0,0,1,2,5628
883,883,2015-08-08,0,0,1,0,5628
884,884,2015-08-09,6,9,9,-3,5625
885,885,2015-08-10,6,6,8,-12,5613
886,886,2015-08-11,2,4,2,4,5617
887,887,2015-08-12,0,1,1,-2,5615
888,888,2015-08-13,4,5,6,12,5627
889,889,2015-08-15,6,9,6,-5,5622
890,890,2015-08-16,0,1,0,0,5622
891,891,2015-08-17,3,3,5,-4,5618
892,892,2015-08-18,3,5,6,11,5629
893,893,2015-08-19,47,54,44,45,5674
894,894,2015-08-20,2,2,7,14,5688
895,895,2015-08-21,2,4,2,2,5690
896,896,2015-08-23,0,0,1,2,5692
897,897,2015-08-24,2,3,8,5,5697
898,898,2015-08-25,6,8,6,-4,5693
899,899,2015-08-26,3,3,4,-8,5685
900,900,2015-08-27,1,2,3,5,5690
901,901,2015-08-28,1,1,3,0,5690
902,902,2015-08-29,0,0,2,3,5693
903,903,2015-08-30,0,0,1,-2,5691
904,904,2015-08-31,0,1,5,4,5695
