,Unnamed: 0,review_date,helpful_votes,total_votes,weighted_votes,weighted_ratings,culmulative_weighted_rating
0,0,2002-03-02,320,332,309,0,0
1,1,2002-04-20,78,87,70,140,140
2,2,2002-07-13,4,4,5,10,150
3,3,2002-08-13,26,32,21,-42,108
4,4,2002-08-21,14,18,11,22,130
5,5,2002-11-08,4,4,5,5,135
6,6,2002-12-17,59,61,58,116,251
7,7,2002-12-18,3,3,4,8,259
8,8,2003-01-07,1,1,2,2,261
9,9,2003-01-14,2,5,0,0,261
10,10,2003-01-23,4,4,5,10,271
11,11,2003-01-26,3,6,1,1,272
12,12,2003-02-19,1,6,-3,0,272
13,13,2003-02-27,13,13,14,28,300
14,14,2003-03-11,3,3,4,8,308
15,15,2003-03-31,2,2,3,0,308
16,16,2003-04-02,6,7,6,12,320
17,17,2003-04-09,4,4,5,10,330
18,18,2004-01-06,8,9,8,8,338
19,19,2004-01-22,4,9,0,0,338
20,20,2004-03-04,10,10,11,22,360
21,21,2004-03-15,266,281,252,504,864
22,22,2004-05-25,6,8,5,-10,854
23,23,2004-08-15,5,6,5,-5,849
24,24,2004-11-03,5,5,6,0,849
25,25,2004-11-09,10,10,11,22,871
26,26,2005-04-13,81,83,80,-160,711
27,27,2005-05-25,165,168,163,-326,385
28,28,2005-06-05,3,3,4,8,393
29,29,2005-07-05,15,18,13,26,419
30,30,2005-08-11,9,9,10,0,419
31,31,2005-09-04,5,5,6,12,431
32,32,2005-09-06,66,78,55,110,541
33,33,2005-09-15,263,270,257,257,798
34,34,2005-09-21,17,18,17,34,832
35,35,2005-09-22,80,96,65,0,832
36,36,2005-09-25,3,3,4,4,836
37,37,2005-10-10,9,10,9,18,854
38,38,2005-10-14,5,5,6,12,866
39,39,2005-10-17,4,4,5,10,876
40,40,2005-11-07,92,96,89,-89,787
41,41,2005-11-30,13,16,11,22,809
42,42,2005-12-08,5,7,4,8,817
43,43,2005-12-25,3,4,3,0,817
44,44,2005-12-28,40,43,38,76,893
45,45,2005-12-29,6,7,6,12,905
46,46,2006-01-05,30,32,30,7,912
47,47,2006-01-13,4,4,5,10,922
48,48,2006-01-18,6,6,7,14,936
49,49,2006-01-19,128,139,118,-118,818
50,50,2006-01-23,51,51,52,-52,766
51,51,2006-01-28,28,32,26,8,774
52,52,2006-01-30,57,59,57,-98,676
53,53,2006-02-01,1,2,1,-2,674
54,54,2006-02-03,3,4,3,-3,671
55,55,2006-02-04,7,10,5,-10,661
56,56,2006-02-17,5,6,5,5,666
57,57,2006-02-23,14,14,16,32,698
58,58,2006-02-24,32,34,34,31,729
59,59,2006-02-27,10,11,10,-20,709
60,60,2006-02-28,2,2,3,6,715
61,61,2006-03-02,20,20,22,33,748
62,62,2006-03-03,3,5,2,4,752
63,63,2006-03-04,96,96,97,-194,558
64,64,2006-03-08,12,17,10,15,573
65,65,2006-03-12,9,9,11,1,574
66,66,2006-03-19,26,28,27,8,582
67,67,2006-03-23,13,14,13,-13,569
68,68,2006-04-09,10,12,9,9,578
69,69,2006-04-16,3,26,-19,-19,559
70,70,2006-04-30,9,10,9,-18,541
71,71,2006-05-13,22,27,18,-36,505
72,72,2006-05-28,99,107,92,0,505
73,73,2006-05-30,63,64,63,-126,379
74,74,2006-06-04,12,16,9,-18,361
75,75,2006-06-06,3,5,2,-4,357
76,76,2006-06-08,8,13,4,-8,349
77,77,2006-06-17,24,24,25,50,399
78,78,2006-06-22,6,7,6,-6,393
79,79,2006-07-06,12,12,13,-13,380
80,80,2006-07-09,12,16,9,9,389
81,81,2006-07-10,13,13,14,14,403
82,82,2006-08-06,1,3,0,0,403
83,83,2006-08-20,9,9,10,20,423
84,84,2006-08-21,4,5,4,-8,415
85,85,2006-08-23,5,5,6,0,415
86,86,2006-09-03,1,3,0,0,415
87,87,2006-09-06,42,48,37,-37,378
88,88,2006-09-30,5,5,6,-12,366
89,89,2006-10-09,3,5,2,-2,364
90,90,2006-10-18,3,4,3,-6,358
91,91,2006-11-03,5,7,5,7,365
92,92,2006-11-04,8,9,9,12,377
93,93,2006-11-05,68,74,64,98,475
94,94,2006-11-16,8,9,8,8,483
95,95,2006-11-17,1,5,-2,-2,481
96,96,2006-11-19,5,5,6,-12,469
97,97,2006-11-27,3,18,-11,22,491
98,98,2006-12-01,4,4,5,10,501
99,99,2006-12-02,257,262,254,504,1005
100,100,2007-01-03,21,25,21,42,1047
101,101,2007-01-05,199,209,191,410,1457
102,102,2007-01-07,33,38,29,0,1457
103,103,2007-01-09,37,43,36,69,1526
104,104,2007-01-11,2,2,3,6,1532
105,105,2007-01-12,8,8,10,18,1550
106,106,2007-01-15,35,41,31,-2,1548
107,107,2007-01-18,1,1,2,2,1550
108,108,2007-01-22,14,15,14,-14,1536
109,109,2007-01-24,20,21,20,40,1576
110,110,2007-01-27,2,6,-1,2,1578
111,111,2007-01-30,0,1,0,0,1578
112,112,2007-02-06,13,14,13,13,1591
113,113,2007-02-17,0,0,1,2,1593
114,114,2007-02-19,2,3,2,4,1597
115,115,2007-02-21,13,13,14,28,1625
116,116,2007-02-24,20,26,15,30,1655
117,117,2007-03-08,1,1,2,4,1659
118,118,2007-03-09,1,2,2,2,1661
119,119,2007-03-10,17,17,19,36,1697
120,120,2007-03-12,1,1,3,4,1701
121,121,2007-03-13,28,31,27,-2,1699
122,122,2007-03-21,14,16,15,13,1712
123,123,2007-03-22,0,0,1,1,1713
124,124,2007-03-27,6,6,7,14,1727
125,125,2007-03-30,7,9,6,-12,1715
126,126,2007-04-01,261,292,232,-463,1252
127,127,2007-04-05,5,5,7,12,1264
128,128,2007-04-09,0,0,1,2,1266
129,129,2007-04-10,14,14,16,32,1298
130,130,2007-04-12,1,1,2,4,1302
131,131,2007-04-14,43,55,38,3,1305
132,132,2007-04-15,91,100,96,146,1451
133,133,2007-04-22,2,2,3,-6,1445
134,134,2007-04-24,0,0,1,-1,1444
135,135,2007-05-02,35,36,35,35,1479
136,136,2007-05-06,18,19,22,37,1516
137,137,2007-05-13,12,13,13,26,1542
138,138,2007-05-14,8,10,8,10,1552
139,139,2007-05-21,60,61,60,-60,1492
140,140,2007-05-22,69,73,67,-130,1362
141,141,2007-05-25,58,59,59,118,1480
142,142,2007-05-26,0,0,1,1,1481
143,143,2007-05-27,1,2,1,-2,1479
144,144,2007-05-30,39,39,40,40,1519
145,145,2007-06-02,2,3,3,4,1523
146,146,2007-06-05,3,7,0,0,1523
147,147,2007-06-07,121,123,120,240,1763
148,148,2007-06-08,9,13,8,-9,1754
149,149,2007-06-11,5,6,6,10,1764
150,150,2007-06-12,0,0,1,0,1764
151,151,2007-06-13,5,6,5,10,1774
152,152,2007-06-15,79,85,74,148,1922
153,153,2007-06-18,16,17,16,-32,1890
154,154,2007-06-28,15,19,12,-12,1878
155,155,2007-07-01,1,2,1,2,1880
156,156,2007-07-13,88,96,81,-162,1718
157,157,2007-07-14,14,18,11,0,1718
158,158,2007-07-15,1,1,2,2,1720
159,159,2007-07-19,4,4,5,5,1725
160,160,2007-07-27,1,1,2,2,1727
161,161,2007-07-28,18,20,19,18,1745
162,162,2007-08-01,2,2,3,6,1751
163,163,2007-08-04,3,3,4,8,1759
164,164,2007-08-06,9,9,11,11,1770
165,165,2007-08-07,1,1,2,4,1774
166,166,2007-08-09,64,77,53,-50,1724
167,167,2007-08-13,0,1,0,0,1724
168,168,2007-08-17,2,2,3,6,1730
169,169,2007-08-20,2,2,3,-6,1724
170,170,2007-08-21,7,8,7,0,1724
171,171,2007-08-27,304,315,294,-588,1136
172,172,2007-08-31,0,0,1,0,1136
173,173,2007-09-04,5,5,6,12,1148
174,174,2007-09-05,71,72,71,142,1290
175,175,2007-09-15,11,14,9,18,1308
176,176,2007-09-17,7,9,6,12,1320
177,177,2007-09-20,0,1,0,0,1320
178,178,2007-09-23,1,1,3,6,1326
179,179,2007-09-25,4,5,5,6,1332
180,180,2007-09-27,1,1,2,4,1336
181,181,2007-10-01,2,2,4,6,1342
182,182,2007-10-02,1,7,-4,8,1350
183,183,2007-10-05,1,1,2,4,1354
184,184,2007-10-09,3,4,3,3,1357
185,185,2007-10-12,10,11,12,8,1365
186,186,2007-10-13,2,4,2,3,1368
187,187,2007-10-16,8,11,6,-6,1362
188,188,2007-10-26,0,0,1,2,1364
189,189,2007-11-05,2,2,4,8,1372
190,190,2007-11-06,2,2,3,6,1378
191,191,2007-11-17,4,5,4,8,1386
192,192,2007-11-25,0,0,1,2,1388
193,193,2007-11-26,19,22,18,18,1406
194,194,2007-11-28,0,0,1,2,1408
195,195,2007-12-01,2,2,5,8,1416
196,196,2007-12-02,2,2,3,-3,1413
197,197,2007-12-04,1,2,2,4,1417
198,198,2007-12-07,1,1,2,4,1421
199,199,2007-12-11,11,12,12,24,1445
200,200,2007-12-12,2,2,3,6,1451
201,201,2007-12-13,10,11,11,20,1471
202,202,2007-12-18,7,7,9,18,1489
203,203,2007-12-21,9,12,9,14,1503
204,204,2007-12-24,8,8,10,20,1523
205,205,2007-12-25,1,1,2,4,1527
206,206,2007-12-28,12,12,15,27,1554
207,207,2007-12-29,1,10,-7,14,1568
208,208,2007-12-31,2,3,2,2,1570
209,209,2008-01-01,16,19,15,-2,1568
210,210,2008-01-07,4,6,3,6,1574
211,211,2008-01-08,16,17,16,32,1606
212,212,2008-01-10,2,2,3,6,1612
213,213,2008-01-11,46,50,44,88,1700
214,214,2008-01-12,11,14,9,-18,1682
215,215,2008-01-13,311,315,311,601,2283
216,216,2008-01-14,2,2,3,6,2289
217,217,2008-01-15,19,19,22,38,2327
218,218,2008-01-18,27,31,25,-42,2285
219,219,2008-01-22,23,25,23,22,2307
220,220,2008-01-28,0,0,2,3,2310
221,221,2008-01-29,2,3,3,6,2316
222,222,2008-01-30,5,5,6,12,2328
223,223,2008-01-31,4,4,5,10,2338
224,224,2008-02-01,3,4,3,-3,2335
225,225,2008-02-05,10,10,11,22,2357
226,226,2008-02-06,0,1,0,0,2357
227,227,2008-02-08,0,0,1,2,2359
228,228,2008-02-09,0,0,1,2,2361
229,229,2008-02-10,2,2,3,3,2364
230,230,2008-02-11,3,4,4,8,2372
231,231,2008-02-12,1,1,2,0,2372
232,232,2008-02-13,1,2,1,-2,2370
233,233,2008-02-15,0,1,2,3,2373
234,234,2008-02-16,0,0,1,2,2375
235,235,2008-02-17,6,7,7,14,2389
236,236,2008-02-18,6,9,6,1,2390
237,237,2008-02-20,10,10,13,-2,2388
238,238,2008-02-22,1,1,3,3,2391
239,239,2008-02-23,0,0,1,2,2393
240,240,2008-02-25,1,1,2,2,2395
241,241,2008-02-27,0,0,1,0,2395
242,242,2008-02-28,0,0,1,1,2396
243,243,2008-02-29,15,16,15,30,2426
244,244,2008-03-03,2,2,4,7,2433
245,245,2008-03-09,0,0,2,3,2436
246,246,2008-03-10,1,1,2,-2,2434
247,247,2008-03-11,3,4,6,6,2440
248,248,2008-03-12,4,4,6,12,2452
249,249,2008-03-13,3,4,3,-3,2449
250,250,2008-03-14,5,5,7,-10,2439
251,251,2008-03-15,4,5,5,10,2449
252,252,2008-03-18,3,4,4,7,2456
253,253,2008-03-19,14,19,12,-20,2436
254,254,2008-03-23,2,2,3,6,2442
255,255,2008-03-25,2,2,3,0,2442
256,256,2008-03-26,1,1,2,4,2446
257,257,2008-03-27,315,325,306,612,3058
258,258,2008-03-30,0,0,1,0,3058
259,259,2008-04-02,26,31,22,-44,3014
260,260,2008-04-06,0,0,2,-1,3013
261,261,2008-04-14,17,18,20,21,3034
262,262,2008-04-15,1,1,3,-3,3031
263,263,2008-04-17,0,0,1,2,3033
264,264,2008-04-21,0,1,1,1,3034
265,265,2008-04-24,8,9,8,16,3050
266,266,2008-04-26,267,279,259,420,3470
267,267,2008-04-27,1,1,2,2,3472
268,268,2008-05-03,4,5,5,-4,3468
269,269,2008-05-04,1,1,4,3,3471
270,270,2008-05-05,38,49,29,-28,3443
271,271,2008-05-08,0,0,1,2,3445
272,272,2008-05-11,0,0,1,1,3446
273,273,2008-05-12,4,5,5,-7,3439
274,274,2008-05-14,2,2,3,6,3445
275,275,2008-05-20,9,10,10,-12,3433
276,276,2008-05-22,2,2,4,8,3441
277,277,2008-05-26,0,0,1,2,3443
278,278,2008-05-27,0,0,1,1,3444
279,279,2008-05-29,87,88,87,174,3618
280,280,2008-06-02,1,1,2,2,3620
281,281,2008-06-03,4,5,5,-5,3615
282,282,2008-06-04,7,7,8,0,3615
283,283,2008-06-07,12,12,14,16,3631
284,284,2008-06-08,4,5,4,4,3635
285,285,2008-06-09,0,1,0,0,3635
286,286,2008-06-15,16,22,11,22,3657
287,287,2008-06-17,1,1,2,2,3659
288,288,2008-06-18,0,0,1,2,3661
289,289,2008-06-19,3,3,6,-2,3659
290,290,2008-06-23,0,0,1,2,3661
291,291,2008-06-24,0,0,1,2,3663
292,292,2008-06-29,5,6,7,6,3669
293,293,2008-07-03,8,12,5,0,3669
294,294,2008-07-06,0,0,1,1,3670
295,295,2008-07-15,16,22,11,0,3670
296,296,2008-07-16,46,54,41,-82,3588
297,297,2008-07-17,6,6,7,14,3602
298,298,2008-07-19,1,1,2,2,3604
299,299,2008-07-20,0,0,1,2,3606
300,300,2008-07-24,23,27,21,42,3648
301,301,2008-07-25,1,2,1,-2,3646
302,302,2008-07-29,1,1,2,4,3650
303,303,2008-08-03,0,0,1,2,3652
304,304,2008-08-06,3,3,4,-8,3644
305,305,2008-08-08,0,0,1,-2,3642
306,306,2008-08-09,0,0,1,2,3644
307,307,2008-08-12,0,0,1,1,3645
308,308,2008-08-13,3,3,6,12,3657
309,309,2008-08-16,0,0,2,0,3657
310,310,2008-08-24,1,1,2,4,3661
311,311,2008-08-25,1,1,2,4,3665
312,312,2008-08-28,2,4,2,0,3665
313,313,2008-09-01,3,3,4,4,3669
314,314,2008-09-03,3,3,4,4,3673
315,315,2008-09-05,1,14,-10,14,3687
316,316,2008-09-07,22,23,23,46,3733
317,317,2008-09-09,1,2,1,1,3734
318,318,2008-09-10,9,9,11,18,3752
319,319,2008-09-13,16,17,16,32,3784
320,320,2008-09-15,0,0,1,1,3785
321,321,2008-09-24,1,2,1,0,3785
322,322,2008-10-01,0,0,1,1,3786
323,323,2008-10-02,3,4,4,8,3794
324,324,2008-10-05,7,7,9,-10,3784
325,325,2008-10-06,5,7,5,3,3787
326,326,2008-10-08,22,26,19,-38,3749
327,327,2008-10-09,1,1,2,0,3749
328,328,2008-10-10,1,1,2,2,3751
329,329,2008-10-14,12,14,13,-20,3731
330,330,2008-10-15,0,4,-3,0,3731
331,331,2008-10-16,2,2,3,6,3737
332,332,2008-10-18,0,0,1,2,3739
333,333,2008-10-24,1,2,1,2,3741
334,334,2008-10-28,0,0,1,2,3743
335,335,2008-10-30,1,1,2,4,3747
336,336,2008-11-01,0,0,1,1,3748
337,337,2008-11-02,0,0,1,2,3750
338,338,2008-11-04,2,2,4,-1,3749
339,339,2008-11-07,1,1,3,6,3755
340,340,2008-11-08,298,325,272,544,4299
341,341,2008-11-10,2,2,4,6,4305
342,342,2008-11-14,55,59,53,-100,4205
343,343,2008-11-16,2,2,3,6,4211
344,344,2008-11-19,0,0,1,2,4213
345,345,2008-11-20,12,13,13,-7,4206
346,346,2008-11-21,6,7,6,-12,4194
347,347,2008-11-23,0,0,1,-1,4193
348,348,2008-11-25,1,1,3,0,4193
349,349,2008-11-27,2,3,2,0,4193
350,350,2008-11-30,0,0,1,1,4194
351,351,2008-12-03,23,28,19,19,4213
352,352,2008-12-04,1,1,2,4,4217
353,353,2008-12-06,1,1,2,2,4219
354,354,2008-12-08,125,133,119,236,4455
355,355,2008-12-16,1,1,2,-4,4451
356,356,2008-12-17,2,2,4,8,4459
357,357,2008-12-20,3,5,4,8,4467
358,358,2008-12-22,1,2,2,0,4467
359,359,2008-12-23,1,2,1,1,4468
360,360,2008-12-24,0,0,1,1,4469
361,361,2008-12-28,1,1,2,4,4473
362,362,2008-12-31,7,8,7,-14,4459
363,363,2009-01-06,2,2,3,3,4462
364,364,2009-01-10,133,149,120,198,4660
365,365,2009-01-11,29,31,30,30,4690
366,366,2009-01-12,168,176,161,-322,4368
367,367,2009-01-14,1,1,2,4,4372
368,368,2009-01-15,1,1,3,6,4378
369,369,2009-01-17,3,6,1,-2,4376
370,370,2009-01-19,7,8,8,16,4392
371,371,2009-01-20,6,7,7,4,4396
372,372,2009-01-21,4,4,6,8,4404
373,373,2009-01-22,7,8,7,7,4411
374,374,2009-01-23,0,1,0,0,4411
375,375,2009-01-25,1,1,2,4,4415
376,376,2009-01-26,51,52,51,-102,4313
377,377,2009-01-27,0,0,1,2,4315
378,378,2009-01-29,0,0,1,1,4316
379,379,2009-01-30,2,2,3,-6,4310
380,380,2009-01-31,10,11,10,0,4310
381,381,2009-02-02,6,7,6,-12,4298
382,382,2009-02-05,34,35,36,69,4367
383,383,2009-02-06,3,3,6,9,4376
384,384,2009-02-07,0,0,1,1,4377
385,385,2009-02-08,0,1,0,0,4377
386,386,2009-02-10,6,6,9,5,4382
387,387,2009-02-11,4,4,6,-8,4374
388,388,2009-02-12,3,3,4,8,4382
389,389,2009-02-14,7,8,8,-6,4376
390,390,2009-02-15,3,4,4,7,4383
391,391,2009-02-16,52,53,52,0,4383
392,392,2009-02-17,0,0,1,2,4385
393,393,2009-02-19,1,2,1,-2,4383
394,394,2009-02-21,8,9,9,1,4384
395,395,2009-02-23,3,8,2,1,4385
396,396,2009-02-24,0,0,1,1,4386
397,397,2009-02-28,1,1,4,7,4393
398,398,2009-03-02,0,0,2,2,4395
399,399,2009-03-06,2,2,3,6,4401
400,400,2009-03-07,304,321,288,576,4977
401,401,2009-03-08,4,5,4,-8,4969
402,402,2009-03-11,23,26,23,-38,4931
403,403,2009-03-12,0,0,2,4,4935
404,404,2009-03-13,0,0,1,2,4937
405,405,2009-03-16,3,3,6,1,4938
406,406,2009-03-17,3,3,5,-3,4935
407,407,2009-03-18,2,2,5,10,4945
408,408,2009-03-19,5,7,6,6,4951
409,409,2009-03-22,16,17,17,-31,4920
410,410,2009-03-24,0,1,0,0,4920
411,411,2009-03-25,4,6,4,7,4927
412,412,2009-03-29,0,0,1,-1,4926
413,413,2009-03-31,1,1,4,5,4931
414,414,2009-04-02,0,0,1,2,4933
415,415,2009-04-04,0,0,3,5,4938
416,416,2009-04-06,1,2,1,1,4939
417,417,2009-04-08,4,4,5,-10,4929
418,418,2009-04-10,0,0,1,2,4931
419,419,2009-04-13,0,0,1,0,4931
420,420,2009-04-19,3,3,4,4,4935
421,421,2009-04-20,1,1,3,6,4941
422,422,2009-04-21,0,0,1,-1,4940
423,423,2009-04-23,1,1,2,4,4944
424,424,2009-04-24,0,0,2,2,4946
425,425,2009-04-25,2,4,3,6,4952
426,426,2009-04-26,1,1,3,6,4958
427,427,2009-04-27,9,10,11,22,4980
428,428,2009-04-28,1,1,2,4,4984
429,429,2009-04-29,0,0,2,4,4988
430,430,2009-04-30,0,0,1,2,4990
431,431,2009-05-01,2,3,4,6,4996
432,432,2009-05-03,0,0,1,2,4998
433,433,2009-05-04,9,11,13,15,5013
434,434,2009-05-05,18,20,20,-23,4990
435,435,2009-05-06,1,1,2,4,4994
436,436,2009-05-07,0,0,2,3,4997
437,437,2009-05-11,3,4,4,6,5003
438,438,2009-05-12,1,2,2,-1,5002
439,439,2009-05-14,2,2,4,6,5008
440,440,2009-05-15,0,0,1,2,5010
441,441,2009-05-16,3,4,3,6,5016
442,442,2009-05-19,0,1,0,0,5016
443,443,2009-05-24,2,2,4,1,5017
444,444,2009-05-26,0,1,1,2,5019
445,445,2009-05-27,0,0,1,2,5021
446,446,2009-05-28,0,0,2,4,5025
447,447,2009-05-29,7,10,7,-6,5019
448,448,2009-05-30,1,2,1,2,5021
449,449,2009-05-31,0,0,1,1,5022
450,450,2009-06-04,1,1,2,4,5026
451,451,2009-06-08,9,10,9,18,5044
452,452,2009-06-11,5,6,5,0,5044
453,453,2009-06-13,5,5,6,12,5056
454,454,2009-06-17,1,1,2,4,5060
455,455,2009-06-18,0,0,1,2,5062
456,456,2009-06-19,5,6,5,-5,5057
457,457,2009-06-21,9,10,11,18,5075
458,458,2009-06-22,0,0,1,1,5076
459,459,2009-06-23,45,57,34,68,5144
460,460,2009-06-24,21,22,22,44,5188
461,461,2009-06-25,0,0,1,2,5190
462,462,2009-06-26,3,4,5,8,5198
463,463,2009-07-01,2,2,3,6,5204
464,464,2009-07-04,0,0,1,2,5206
465,465,2009-07-05,6,7,7,-10,5196
466,466,2009-07-07,6,6,7,7,5203
467,467,2009-07-09,3,4,3,-6,5197
468,468,2009-07-11,0,0,1,2,5199
469,469,2009-07-12,0,0,1,0,5199
470,470,2009-07-13,6,7,6,6,5205
471,471,2009-07-14,9,10,9,-9,5196
472,472,2009-07-16,0,0,1,2,5198
473,473,2009-07-20,4,4,6,11,5209
474,474,2009-08-03,5,5,6,12,5221
475,475,2009-08-04,1,1,2,-4,5217
476,476,2009-08-06,1,6,-2,2,5219
477,477,2009-08-10,1,2,2,4,5223
478,478,2009-08-11,1,1,3,5,5228
479,479,2009-08-12,0,0,1,1,5229
480,480,2009-08-14,62,66,60,110,5339
481,481,2009-08-16,16,18,18,36,5375
482,482,2009-08-20,6,6,7,14,5389
483,483,2009-08-21,3,11,-4,0,5389
484,484,2009-08-24,6,7,9,14,5403
485,485,2009-08-27,1,1,2,4,5407
486,486,2009-08-28,0,0,1,2,5409
487,487,2009-09-02,1,1,2,4,5413
488,488,2009-09-05,5,14,-1,6,5419
489,489,2009-09-07,0,0,2,3,5422
490,490,2009-09-08,1,1,2,2,5424
491,491,2009-09-09,0,0,1,1,5425
492,492,2009-09-11,15,15,19,3,5428
493,493,2009-09-14,0,0,1,2,5430
494,494,2009-09-15,0,0,1,2,5432
495,495,2009-09-17,0,0,1,-1,5431
496,496,2009-09-20,0,0,2,2,5433
497,497,2009-09-22,0,0,1,1,5434
498,498,2009-09-23,2,2,3,-6,5428
499,499,2009-09-25,96,102,92,183,5611
500,500,2009-09-26,39,48,32,-12,5599
501,501,2009-09-27,0,2,-1,1,5600
502,502,2009-09-30,0,0,1,2,5602
503,503,2009-10-01,0,0,1,2,5604
504,504,2009-10-02,6,7,6,6,5610
505,505,2009-10-05,2,4,2,5,5615
506,506,2009-10-12,1,1,2,4,5619
507,507,2009-10-13,6,7,6,-12,5607
508,508,2009-10-14,1,1,2,2,5609
509,509,2009-10-15,114,130,101,2,5611
510,510,2009-10-18,1,1,2,0,5611
511,511,2009-10-20,1,1,3,4,5615
512,512,2009-10-21,3,3,5,10,5625
513,513,2009-10-22,11,11,13,16,5641
514,514,2009-10-23,0,0,1,2,5643
515,515,2009-10-26,15,22,11,7,5650
516,516,2009-10-28,8,9,8,8,5658
517,517,2009-10-29,3,4,3,6,5664
518,518,2009-10-30,18,18,20,40,5704
519,519,2009-10-31,0,0,1,1,5705
520,520,2009-11-04,1,1,2,4,5709
521,521,2009-11-07,0,0,1,2,5711
522,522,2009-11-08,12,13,12,-24,5687
523,523,2009-11-09,5,6,7,6,5693
524,524,2009-11-12,0,0,1,-1,5692
525,525,2009-11-21,0,0,1,2,5694
526,526,2009-11-26,5,6,5,-10,5684
527,527,2009-12-01,3,4,4,0,5684
528,528,2009-12-02,11,15,10,32,5716
529,529,2009-12-03,0,1,0,0,5716
530,530,2009-12-04,4,5,5,9,5725
531,531,2009-12-05,1,2,3,6,5731
532,532,2009-12-07,1,1,3,4,5735
533,533,2009-12-09,0,0,1,-2,5733
534,534,2009-12-10,1,1,2,4,5737
535,535,2009-12-13,9,9,11,-19,5718
536,536,2009-12-14,2,2,3,-3,5715
537,537,2009-12-16,0,2,-1,0,5715
538,538,2009-12-17,1,1,2,4,5719
539,539,2009-12-18,3,11,-3,9,5728
540,540,2009-12-21,1,3,1,2,5730
541,541,2009-12-22,0,0,3,2,5732
542,542,2009-12-23,3,3,5,-2,5730
543,543,2009-12-24,0,0,1,2,5732
544,544,2009-12-26,0,0,1,1,5733
545,545,2009-12-28,1,2,1,2,5735
546,546,2009-12-29,0,0,1,1,5736
547,547,2010-01-02,7,10,6,8,5744
548,548,2010-01-05,2,3,2,4,5748
549,549,2010-01-07,1,1,3,6,5754
550,550,2010-01-09,1,1,3,6,5760
551,551,2010-01-15,0,0,1,1,5761
552,552,2010-01-16,0,0,1,0,5761
553,553,2010-01-17,51,56,48,93,5854
554,554,2010-01-19,0,0,1,2,5856
555,555,2010-01-22,0,0,2,3,5859
556,556,2010-01-24,1,2,2,2,5861
557,557,2010-01-27,0,0,1,1,5862
558,558,2010-01-28,0,0,1,2,5864
559,559,2010-01-30,4,5,7,2,5866
560,560,2010-01-31,11,11,13,26,5892
561,561,2010-02-01,0,0,3,2,5894
562,562,2010-02-03,3,3,4,8,5902
563,563,2010-02-04,0,1,0,0,5902
564,564,2010-02-05,0,0,2,4,5906
565,565,2010-02-06,40,41,42,84,5990
566,566,2010-02-07,0,0,3,5,5995
567,567,2010-02-09,0,0,1,2,5997
568,568,2010-02-11,2,2,3,3,6000
569,569,2010-02-13,0,0,2,0,6000
570,570,2010-02-14,2,2,3,6,6006
571,571,2010-02-15,0,1,0,0,6006
572,572,2010-02-17,0,0,1,1,6007
573,573,2010-02-19,0,1,2,4,6011
574,574,2010-02-21,1,1,2,-4,6007
575,575,2010-02-22,2,2,4,-2,6005
576,576,2010-02-26,32,34,31,31,6036
577,577,2010-03-01,0,0,1,0,6036
578,578,2010-03-03,2,2,4,-5,6031
579,579,2010-03-04,6,7,7,-2,6029
580,580,2010-03-05,0,0,1,2,6031
581,581,2010-03-06,1,1,3,-2,6029
582,582,2010-03-09,1,1,2,4,6033
583,583,2010-03-10,525,607,445,890,6923
584,584,2010-03-11,126,161,125,151,7074
585,585,2010-03-13,0,0,1,2,7076
586,586,2010-03-15,2,2,4,-5,7071
587,587,2010-03-20,5,7,4,-8,7063
588,588,2010-03-21,0,0,1,2,7065
589,589,2010-03-24,0,0,2,4,7069
590,590,2010-03-28,0,0,1,1,7070
591,591,2010-03-30,3,3,4,4,7074
592,592,2010-03-31,1,2,1,-2,7072
593,593,2010-04-01,0,0,1,2,7074
594,594,2010-04-03,0,0,1,1,7075
595,595,2010-04-05,16,17,16,32,7107
596,596,2010-04-06,2,2,4,8,7115
597,597,2010-04-07,5,7,4,-8,7107
598,598,2010-04-10,0,0,1,1,7108
599,599,2010-04-11,21,31,12,12,7120
600,600,2010-04-14,7,8,8,2,7122
601,601,2010-04-16,0,0,1,-2,7120
602,602,2010-04-18,2,12,-6,20,7140
603,603,2010-04-19,12,51,-26,52,7192
604,604,2010-04-20,2,2,4,-8,7184
605,605,2010-04-21,24,24,26,20,7204
606,606,2010-04-22,0,0,1,0,7204
607,607,2010-04-24,1,1,4,4,7208
608,608,2010-04-26,1,7,-2,6,7214
609,609,2010-04-29,0,0,1,2,7216
610,610,2010-04-30,0,0,1,2,7218
611,611,2010-05-02,0,0,1,-2,7216
612,612,2010-05-06,31,44,28,-2,7214
613,613,2010-05-07,48,66,47,28,7242
614,614,2010-05-11,4,4,6,12,7254
615,615,2010-05-13,0,0,1,2,7256
616,616,2010-05-14,0,0,1,2,7258
617,617,2010-05-15,4,4,5,5,7263
618,618,2010-05-16,2,2,3,-3,7260
619,619,2010-05-19,2,3,2,2,7262
620,620,2010-05-20,25,31,22,-22,7240
621,621,2010-05-21,0,0,1,2,7242
622,622,2010-05-22,13,15,12,24,7266
623,623,2010-05-24,0,0,1,-2,7264
624,624,2010-05-27,0,0,1,2,7266
625,625,2010-05-28,0,0,1,1,7267
626,626,2010-05-30,47,48,48,96,7363
627,627,2010-05-31,0,0,1,2,7365
628,628,2010-06-01,0,0,1,2,7367
629,629,2010-06-03,7,8,7,7,7374
630,630,2010-06-04,0,0,1,2,7376
631,631,2010-06-07,6,7,9,-10,7366
632,632,2010-06-08,1,1,3,1,7367
633,633,2010-06-10,0,0,1,1,7368
634,634,2010-06-12,2,2,4,4,7372
635,635,2010-06-14,3,3,4,-8,7364
636,636,2010-06-15,5,6,7,-4,7360
637,637,2010-06-17,1,2,1,2,7362
638,638,2010-06-22,4,5,4,-8,7354
639,639,2010-06-23,0,0,1,2,7356
640,640,2010-06-24,4,4,8,10,7366
641,641,2010-06-25,0,0,1,2,7368
642,642,2010-06-28,92,98,88,89,7457
643,643,2010-06-30,69,83,58,-49,7408
644,644,2010-07-02,1,1,2,-4,7404
645,645,2010-07-05,3,5,4,4,7408
646,646,2010-07-07,14,14,17,-23,7385
647,647,2010-07-08,2,2,3,3,7388
648,648,2010-07-11,0,0,1,2,7390
649,649,2010-07-12,1,1,3,0,7390
650,650,2010-07-14,3,3,6,12,7402
651,651,2010-07-18,0,1,0,0,7402
652,652,2010-07-19,14,16,13,26,7428
653,653,2010-07-20,4,4,5,5,7433
654,654,2010-07-23,1,2,1,2,7435
655,655,2010-07-24,35,40,32,-64,7371
656,656,2010-07-25,91,98,86,86,7457
657,657,2010-07-28,0,0,1,2,7459
658,658,2010-08-05,925,1092,904,940,8399
659,659,2010-08-06,43,43,46,89,8488
660,660,2010-08-09,0,0,1,1,8489
661,661,2010-08-16,0,0,2,3,8492
662,662,2010-08-17,5,6,7,12,8504
663,663,2010-08-18,0,0,1,2,8506
664,664,2010-08-19,5,5,8,-4,8502
665,665,2010-08-20,2,2,3,6,8508
666,666,2010-08-21,1,1,2,4,8512
667,667,2010-08-24,22,29,17,-32,8480
668,668,2010-08-27,0,0,1,2,8482
669,669,2010-08-28,2,2,3,-6,8476
670,670,2010-09-03,4,4,7,7,8483
671,671,2010-09-04,0,0,1,2,8485
672,672,2010-09-05,1,2,1,2,8487
673,673,2010-09-06,21,23,22,-29,8458
674,674,2010-09-09,0,0,1,0,8458
675,675,2010-09-11,2,2,3,6,8464
676,676,2010-09-12,20,36,6,27,8491
677,677,2010-09-13,0,0,1,-1,8490
678,678,2010-09-14,0,0,1,0,8490
679,679,2010-09-15,2,2,4,-8,8482
680,680,2010-09-16,1,2,1,-2,8480
681,681,2010-09-19,0,0,1,-2,8478
682,682,2010-09-20,3,4,5,6,8484
683,683,2010-09-21,4,4,7,-4,8480
684,684,2010-09-22,4,8,3,8,8488
685,685,2010-09-24,0,1,3,6,8494
686,686,2010-09-25,0,0,2,3,8497
687,687,2010-09-26,1,1,2,-2,8495
688,688,2010-09-27,0,0,1,1,8496
689,689,2010-09-29,16,19,14,28,8524
690,690,2010-10-02,1,2,1,1,8525
691,691,2010-10-03,1,1,4,6,8531
692,692,2010-10-05,0,0,2,4,8535
693,693,2010-10-06,0,0,1,2,8537
694,694,2010-10-07,34,35,39,74,8611
695,695,2010-10-08,0,0,1,2,8613
696,696,2010-10-09,3,4,3,-6,8607
697,697,2010-10-11,3,4,6,-5,8602
698,698,2010-10-12,0,0,2,1,8603
699,699,2010-10-14,1,1,2,4,8607
700,700,2010-10-15,0,0,2,3,8610
701,701,2010-10-16,0,0,1,2,8612
702,702,2010-10-17,9,13,8,5,8617
703,703,2010-10-18,0,0,1,-2,8615
704,704,2010-10-19,47,52,45,75,8690
705,705,2010-10-22,5,10,4,10,8700
706,706,2010-10-23,0,0,2,-1,8699
707,707,2010-10-24,0,0,1,1,8700
708,708,2010-10-26,1,3,2,-3,8697
709,709,2010-10-27,2,2,3,6,8703
710,710,2010-10-31,3,3,4,-8,8695
711,711,2010-11-02,1,2,1,-2,8693
712,712,2010-11-06,0,0,1,1,8694
713,713,2010-11-07,0,0,1,2,8696
714,714,2010-11-08,1,1,2,2,8698
715,715,2010-11-09,0,0,2,1,8699
716,716,2010-11-10,1,1,3,-2,8697
717,717,2010-11-11,0,0,1,2,8699
718,718,2010-11-13,0,0,2,2,8701
719,719,2010-11-14,0,0,1,2,8703
720,720,2010-11-15,3,3,4,8,8711
721,721,2010-11-16,1,1,2,4,8715
722,722,2010-11-17,1,1,2,2,8717
723,723,2010-11-18,2,2,3,6,8723
724,724,2010-11-20,6,7,6,-6,8717
725,725,2010-11-21,1,1,2,4,8721
726,726,2010-11-22,10,15,8,16,8737
727,727,2010-11-23,2,3,2,4,8741
728,728,2010-11-24,0,0,2,4,8745
729,729,2010-11-25,5,7,5,-4,8741
730,730,2010-11-27,7,7,10,2,8743
731,731,2010-11-28,1,2,3,6,8749
732,732,2010-11-29,13,30,1,45,8794
733,733,2010-12-02,1,1,2,2,8796
734,734,2010-12-03,1,1,3,6,8802
735,735,2010-12-04,183,219,166,204,9006
736,736,2010-12-05,0,0,2,4,9010
737,737,2010-12-07,0,0,1,-1,9009
738,738,2010-12-08,0,0,1,2,9011
739,739,2010-12-09,0,0,1,2,9013
740,740,2010-12-10,5,6,9,1,9014
741,741,2010-12-11,0,0,1,2,9016
742,742,2010-12-13,0,0,3,6,9022
743,743,2010-12-14,0,0,3,4,9026
744,744,2010-12-15,6,7,7,14,9040
745,745,2010-12-16,29,29,32,64,9104
746,746,2010-12-17,21,23,23,32,9136
747,747,2010-12-19,7,10,5,5,9141
748,748,2010-12-20,2,2,3,6,9147
749,749,2010-12-21,1,1,4,6,9153
750,750,2010-12-22,1,1,3,6,9159
751,751,2010-12-26,10,13,8,16,9175
752,752,2010-12-27,14,18,14,-12,9163
753,753,2010-12-28,3,4,3,-6,9157
754,754,2010-12-29,1,13,-8,15,9172
755,755,2010-12-31,13,17,12,-14,9158
756,756,2011-01-01,2,2,3,3,9161
757,757,2011-01-02,10,14,8,-12,9149
758,758,2011-01-03,0,0,3,3,9152
759,759,2011-01-04,0,0,1,2,9154
760,760,2011-01-05,10,12,10,22,9176
761,761,2011-01-08,10,11,12,18,9194
762,762,2011-01-10,9,11,11,6,9200
763,763,2011-01-11,14,21,9,-7,9193
764,764,2011-01-12,0,0,1,0,9193
765,765,2011-01-13,16,17,21,29,9222
766,766,2011-01-14,3,4,4,-3,9219
767,767,2011-01-15,31,40,27,-29,9190
768,768,2011-01-16,0,0,1,2,9192
769,769,2011-01-17,3,3,4,-8,9184
770,770,2011-01-18,4,5,7,8,9192
771,771,2011-01-19,0,1,0,0,9192
772,772,2011-01-20,2,2,6,8,9200
773,773,2011-01-21,6,6,9,18,9218
774,774,2011-01-24,10,13,8,8,9226
775,775,2011-01-25,77,84,76,26,9252
776,776,2011-01-26,0,0,1,-2,9250
777,777,2011-01-27,0,0,1,0,9250
778,778,2011-01-29,1,1,3,5,9255
779,779,2011-01-31,5,5,7,2,9257
780,780,2011-02-02,8,8,9,18,9275
781,781,2011-02-03,22,28,19,-30,9245
782,782,2011-02-06,2,2,5,2,9247
783,783,2011-02-09,1,2,1,0,9247
784,784,2011-02-10,0,0,2,0,9247
785,785,2011-02-11,2,2,3,6,9253
786,786,2011-02-14,5,6,7,-3,9250
787,787,2011-02-15,3,4,3,-3,9247
788,788,2011-02-17,3,5,8,4,9251
789,789,2011-02-19,13,17,10,-20,9231
790,790,2011-02-22,1,1,2,4,9235
791,791,2011-02-24,0,1,0,0,9235
792,792,2011-02-25,5,5,7,11,9246
793,793,2011-02-26,178,213,190,209,9455
794,794,2011-02-27,0,0,1,1,9456
795,795,2011-02-28,9,11,8,8,9464
796,796,2011-03-01,2,2,4,8,9472
797,797,2011-03-02,342,369,319,398,9870
798,798,2011-03-04,0,0,1,2,9872
799,799,2011-03-05,0,0,1,2,9874
800,800,2011-03-06,0,0,1,2,9876
801,801,2011-03-07,10,12,11,10,9886
802,802,2011-03-08,16,18,15,30,9916
803,803,2011-03-09,18,19,21,39,9955
804,804,2011-03-11,1,1,2,2,9957
805,805,2011-03-13,2,2,4,4,9961
806,806,2011-03-14,12,14,13,13,9974
807,807,2011-03-15,2,2,3,6,9980
808,808,2011-03-16,0,0,1,-2,9978
809,809,2011-03-17,1,1,4,6,9984
810,810,2011-03-18,0,0,1,-2,9982
811,811,2011-03-20,3,3,6,3,9985
812,812,2011-03-21,0,1,1,2,9987
813,813,2011-03-22,0,0,1,2,9989
814,814,2011-03-24,1,7,-1,-4,9985
815,815,2011-03-25,0,1,1,2,9987
816,816,2011-03-26,0,0,1,2,9989
817,817,2011-03-27,0,3,-2,0,9989
818,818,2011-03-28,23,24,24,25,10014
819,819,2011-03-29,4,5,4,4,10018
820,820,2011-03-30,0,0,1,2,10020
821,821,2011-04-01,0,0,2,3,10023
822,822,2011-04-03,1,1,2,2,10025
823,823,2011-04-04,1,2,2,-1,10024
824,824,2011-04-05,1,1,2,0,10024
825,825,2011-04-07,2,2,4,7,10031
826,826,2011-04-08,0,0,1,-2,10029
827,827,2011-04-09,13,17,10,0,10029
828,828,2011-04-11,9,10,12,-16,10013
829,829,2011-04-12,6,8,8,-8,10005
830,830,2011-04-13,1,1,3,5,10010
831,831,2011-04-14,0,0,2,2,10012
832,832,2011-04-15,4,5,6,-5,10007
833,833,2011-04-16,20,22,22,13,10020
834,834,2011-04-17,0,0,1,2,10022
835,835,2011-04-19,1,2,1,2,10024
836,836,2011-04-20,1,1,2,4,10028
837,837,2011-04-21,0,0,1,1,10029
838,838,2011-04-23,5,7,7,10,10039
839,839,2011-04-26,4,5,4,8,10047
840,840,2011-04-27,25,27,24,48,10095
841,841,2011-04-28,3,3,4,8,10103
842,842,2011-04-29,0,0,1,2,10105
843,843,2011-04-30,4,7,4,-4,10101
844,844,2011-05-01,1,1,2,4,10105
845,845,2011-05-03,0,0,1,-2,10103
846,846,2011-05-04,0,0,2,0,10103
847,847,2011-05-05,0,1,0,0,10103
848,848,2011-05-07,13,16,13,18,10121
849,849,2011-05-09,15,19,13,26,10147
850,850,2011-05-10,7,10,6,4,10151
851,851,2011-05-11,0,0,1,2,10153
852,852,2011-05-12,11,12,12,-3,10150
853,853,2011-05-13,1,1,3,3,10153
854,854,2011-05-14,2,3,3,6,10159
855,855,2011-05-17,2,5,0,0,10159
856,856,2011-05-18,4,5,5,-9,10150
857,857,2011-05-19,12,14,15,25,10175
858,858,2011-05-21,15,17,15,16,10191
859,859,2011-05-22,11,13,10,20,10211
860,860,2011-05-23,0,0,1,2,10213
861,861,2011-05-24,12,12,15,28,10241
862,862,2011-05-25,1,2,1,2,10243
863,863,2011-05-26,8,11,8,16,10259
864,864,2011-05-27,50,54,47,47,10306
865,865,2011-05-28,3,3,5,9,10315
866,866,2011-05-30,8,8,9,9,10324
867,867,2011-05-31,1,1,2,4,10328
868,868,2011-06-01,2,2,3,0,10328
869,869,2011-06-02,0,0,1,2,10330
870,870,2011-06-03,0,0,1,-1,10329
871,871,2011-06-05,1,1,3,5,10334
872,872,2011-06-06,0,0,1,2,10336
873,873,2011-06-07,0,0,1,2,10338
874,874,2011-06-08,6,7,6,0,10338
875,875,2011-06-09,0,0,4,5,10343
876,876,2011-06-10,2,2,4,8,10351
877,877,2011-06-11,0,0,1,2,10353
878,878,2011-06-12,0,0,1,-2,10351
879,879,2011-06-14,4,4,5,10,10361
880,880,2011-06-15,2,2,5,3,10364
881,881,2011-06-16,7,8,12,16,10380
882,882,2011-06-17,1,1,2,4,10384
883,883,2011-06-18,2,3,3,-2,10382
884,884,2011-06-20,0,0,1,-2,10380
885,885,2011-06-23,0,0,2,0,10380
886,886,2011-06-24,4,4,5,10,10390
887,887,2011-06-25,0,0,1,2,10392
888,888,2011-06-28,0,1,0,0,10392
889,889,2011-06-29,1,1,3,-3,10389
890,890,2011-07-01,3,3,7,-2,10387
891,891,2011-07-02,195,240,205,284,10671
892,892,2011-07-03,4,4,6,-9,10662
893,893,2011-07-06,0,0,1,1,10663
894,894,2011-07-07,3,3,4,4,10667
895,895,2011-07-08,97,102,93,93,10760
896,896,2011-07-09,0,0,1,-2,10758
897,897,2011-07-11,0,1,0,0,10758
898,898,2011-07-12,1,1,2,4,10762
899,899,2011-07-13,0,0,1,-2,10760
900,900,2011-07-14,5,6,6,12,10772
901,901,2011-07-16,63,68,59,59,10831
902,902,2011-07-17,3,16,-9,18,10849
903,903,2011-07-18,0,1,0,0,10849
904,904,2011-07-19,2,2,3,6,10855
905,905,2011-07-20,10,10,14,7,10862
906,906,2011-07-21,0,0,1,0,10862
907,907,2011-07-22,9,10,9,18,10880
908,908,2011-07-24,7,10,7,-2,10878
909,909,2011-07-26,1,2,2,2,10880
910,910,2011-07-27,1,1,3,6,10886
911,911,2011-07-28,10,13,12,14,10900
912,912,2011-07-29,6,7,7,-11,10889
913,913,2011-07-30,1,1,5,7,10896
914,914,2011-07-31,1,1,2,4,10900
915,915,2011-08-01,7,8,9,11,10911
916,916,2011-08-02,0,0,1,2,10913
917,917,2011-08-05,0,1,0,0,10913
918,918,2011-08-08,3,4,4,8,10921
919,919,2011-08-10,3,3,4,8,10929
920,920,2011-08-11,2,3,2,4,10933
921,921,2011-08-12,30,31,31,61,10994
922,922,2011-08-15,36,37,37,-74,10920
923,923,2011-08-16,3,4,4,1,10921
924,924,2011-08-17,0,0,2,4,10925
925,925,2011-08-18,3,4,3,6,10931
926,926,2011-08-19,88,101,77,68,10999
927,927,2011-08-20,6,7,8,1,11000
928,928,2011-08-21,1,2,2,4,11004
929,929,2011-08-22,7,7,11,-10,10994
930,930,2011-08-23,0,0,2,3,10997
931,931,2011-08-24,0,0,1,0,10997
932,932,2011-08-25,1,1,2,4,11001
933,933,2011-08-27,3,3,5,7,11008
934,934,2011-08-28,84,95,75,150,11158
935,935,2011-08-29,15,16,18,28,11186
936,936,2011-08-30,0,0,1,2,11188
937,937,2011-09-01,1,1,3,-2,11186
938,938,2011-09-03,0,0,1,2,11188
939,939,2011-09-04,0,0,1,2,11190
940,940,2011-09-07,18,20,18,-36,11154
941,941,2011-09-08,0,0,1,2,11156
942,942,2011-09-10,0,0,1,0,11156
943,943,2011-09-11,1,1,2,0,11156
944,944,2011-09-12,1,1,3,-6,11150
945,945,2011-09-13,2,4,2,4,11154
946,946,2011-09-14,1,1,2,4,11158
947,947,2011-09-15,13,17,12,23,11181
948,948,2011-09-16,3,4,5,2,11183
949,949,2011-09-19,9,10,13,1,11184
950,950,2011-09-20,2,2,4,8,11192
951,951,2011-09-21,5,5,10,-2,11190
952,952,2011-09-22,0,0,1,2,11192
953,953,2011-09-23,0,0,1,2,11194
954,954,2011-09-25,0,0,2,4,11198
955,955,2011-09-29,2,3,3,5,11203
956,956,2011-10-03,3,6,1,-2,11201
957,957,2011-10-04,0,0,1,2,11203
958,958,2011-10-07,1,1,2,2,11205
959,959,2011-10-08,0,0,1,2,11207
960,960,2011-10-09,9,9,10,20,11227
961,961,2011-10-10,13,19,11,-1,11226
962,962,2011-10-11,1,1,2,4,11230
963,963,2011-10-13,0,0,1,2,11232
964,964,2011-10-15,8,8,9,-18,11214
965,965,2011-10-16,0,0,2,4,11218
966,966,2011-10-18,3,4,4,1,11219
967,967,2011-10-19,1,1,3,3,11222
968,968,2011-10-20,0,0,1,0,11222
969,969,2011-10-21,10,16,9,-11,11211
970,970,2011-10-22,12,13,17,13,11224
971,971,2011-10-23,2,2,4,-2,11222
972,972,2011-10-25,0,0,1,2,11224
973,973,2011-10-27,2,3,3,5,11229
974,974,2011-10-28,5,7,4,8,11237
975,975,2011-10-29,1,1,2,4,11241
976,976,2011-10-31,2,3,3,0,11241
977,977,2011-11-02,1,1,4,1,11242
978,978,2011-11-03,0,0,1,1,11243
979,979,2011-11-04,0,1,0,0,11243
980,980,2011-11-05,3,3,4,8,11251
981,981,2011-11-07,3,4,4,5,11256
982,982,2011-11-10,3,4,6,12,11268
983,983,2011-11-11,0,0,2,4,11272
984,984,2011-11-14,0,0,1,2,11274
985,985,2011-11-15,2,2,4,-5,11269
986,986,2011-11-16,2,3,2,0,11269
987,987,2011-11-17,6,7,8,4,11273
988,988,2011-11-18,2,5,0,0,11273
989,989,2011-11-19,9,13,8,-12,11261
990,990,2011-11-20,0,0,1,1,11262
991,991,2011-11-21,7,11,6,12,11274
992,992,2011-11-22,11,17,8,24,11298
993,993,2011-11-25,5,5,7,14,11312
994,994,2011-11-26,0,0,1,2,11314
995,995,2011-11-27,1,3,1,-2,11312
996,996,2011-11-28,6,21,-6,-14,11298
997,997,2011-11-29,1,1,4,8,11306
998,998,2011-11-30,3,4,3,6,11312
999,999,2011-12-03,6,7,7,2,11314
1000,1000,2011-12-04,4,6,5,8,11322
1001,1001,2011-12-05,0,0,1,2,11324
1002,1002,2011-12-06,0,0,1,0,11324
1003,1003,2011-12-07,6,9,8,11,11335
1004,1004,2011-12-08,439,452,430,431,11766
1005,1005,2011-12-09,21,25,19,36,11802
1006,1006,2011-12-10,0,0,3,3,11805
1007,1007,2011-12-11,0,1,0,0,11805
1008,1008,2011-12-12,8,14,5,5,11810
1009,1009,2011-12-13,10,13,11,17,11827
1010,1010,2011-12-14,2,4,3,5,11832
1011,1011,2011-12-15,0,0,3,5,11837
1012,1012,2011-12-16,3,4,5,8,11845
1013,1013,2011-12-19,4,6,3,6,11851
1014,1014,2011-12-20,12,16,11,0,11851
1015,1015,2011-12-21,0,0,2,4,11855
1016,1016,2011-12-22,13,14,14,4,11859
1017,1017,2011-12-23,0,0,1,0,11859
1018,1018,2011-12-24,1,1,3,3,11862
1019,1019,2011-12-26,0,0,1,2,11864
1020,1020,2011-12-27,2,2,4,8,11872
1021,1021,2011-12-28,16,23,11,21,11893
1022,1022,2011-12-29,5,6,8,7,11900
1023,1023,2011-12-30,1,1,2,2,11902
1024,1024,2011-12-31,12,16,15,-12,11890
1025,1025,2012-01-01,3,5,5,10,11900
1026,1026,2012-01-02,0,0,1,2,11902
1027,1027,2012-01-03,61,68,62,69,11971
1028,1028,2012-01-04,15,18,16,30,12001
1029,1029,2012-01-05,59,67,55,110,12111
1030,1030,2012-01-06,1,5,1,2,12113
1031,1031,2012-01-07,0,0,2,3,12116
1032,1032,2012-01-08,200,209,194,388,12504
1033,1033,2012-01-09,56,80,68,78,12582
1034,1034,2012-01-10,3,4,4,8,12590
1035,1035,2012-01-11,1,1,2,4,12594
1036,1036,2012-01-12,1,1,4,5,12599
1037,1037,2012-01-13,2,3,7,1,12600
1038,1038,2012-01-14,0,0,1,2,12602
1039,1039,2012-01-16,0,0,4,2,12604
1040,1040,2012-01-17,0,0,4,6,12610
1041,1041,2012-01-19,3,4,8,13,12623
1042,1042,2012-01-20,3,5,2,-4,12619
1043,1043,2012-01-21,2,2,3,6,12625
1044,1044,2012-01-22,0,0,1,2,12627
1045,1045,2012-01-23,6,7,7,8,12635
1046,1046,2012-01-24,1,4,1,4,12639
1047,1047,2012-01-25,0,0,1,2,12641
1048,1048,2012-01-26,1,1,5,9,12650
1049,1049,2012-01-27,0,0,1,2,12652
1050,1050,2012-01-30,1,1,3,5,12657
1051,1051,2012-01-31,7,7,8,16,12673
1052,1052,2012-02-01,1,1,3,2,12675
1053,1053,2012-02-02,1,3,3,-3,12672
1054,1054,2012-02-03,0,0,1,1,12673
1055,1055,2012-02-04,19,21,20,-30,12643
1056,1056,2012-02-05,2,2,3,-6,12637
1057,1057,2012-02-06,0,0,1,2,12639
1058,1058,2012-02-07,5,7,7,6,12645
1059,1059,2012-02-08,2,2,4,-1,12644
1060,1060,2012-02-09,0,0,1,2,12646
1061,1061,2012-02-10,29,31,31,41,12687
1062,1062,2012-02-11,4,6,4,4,12691
1063,1063,2012-02-12,0,1,0,0,12691
1064,1064,2012-02-13,0,1,2,4,12695
1065,1065,2012-02-14,2,2,3,6,12701
1066,1066,2012-02-15,1,2,2,3,12704
1067,1067,2012-02-16,12,19,12,4,12708
1068,1068,2012-02-17,2,5,1,2,12710
1069,1069,2012-02-18,0,0,3,5,12715
1070,1070,2012-02-19,6,7,8,14,12729
1071,1071,2012-02-20,2,2,3,6,12735
1072,1072,2012-02-21,92,116,71,-75,12660
1073,1073,2012-02-23,3,3,9,16,12676
1074,1074,2012-02-25,1,1,2,4,12680
1075,1075,2012-02-26,2,2,6,6,12686
1076,1076,2012-02-27,0,0,1,-2,12684
1077,1077,2012-02-28,1,1,3,6,12690
1078,1078,2012-02-29,0,0,1,2,12692
1079,1079,2012-03-01,0,1,0,0,12692
1080,1080,2012-03-02,0,0,1,2,12694
1081,1081,2012-03-03,2,2,4,-4,12690
1082,1082,2012-03-04,1,1,3,2,12692
1083,1083,2012-03-06,3,3,4,8,12700
1084,1084,2012-03-07,28,30,28,56,12756
1085,1085,2012-03-08,1,1,3,6,12762
1086,1086,2012-03-11,4,10,0,6,12768
1087,1087,2012-03-12,20,23,23,28,12796
1088,1088,2012-03-13,1,2,1,2,12798
1089,1089,2012-03-14,1,1,2,4,12802
1090,1090,2012-03-15,5,6,9,4,12806
1091,1091,2012-03-16,5,5,7,7,12813
1092,1092,2012-03-17,0,0,2,0,12813
1093,1093,2012-03-19,0,0,1,1,12814
1094,1094,2012-03-22,5,9,5,4,12818
1095,1095,2012-03-25,4,5,5,8,12826
1096,1096,2012-03-26,75,80,73,146,12972
1097,1097,2012-03-27,0,0,2,-2,12970
1098,1098,2012-03-28,19,19,20,40,13010
1099,1099,2012-03-29,14,17,12,-24,12986
1100,1100,2012-03-30,1,1,2,2,12988
1101,1101,2012-03-31,2,3,3,5,12993
1102,1102,2012-04-01,31,32,31,62,13055
1103,1103,2012-04-02,0,3,0,8,13063
1104,1104,2012-04-04,1,2,3,3,13066
1105,1105,2012-04-05,9,10,10,16,13082
1106,1106,2012-04-06,1,1,2,4,13086
1107,1107,2012-04-07,14,15,16,-28,13058
1108,1108,2012-04-08,3,4,4,7,13065
1109,1109,2012-04-09,6,8,7,2,13067
1110,1110,2012-04-11,1,1,7,6,13073
1111,1111,2012-04-12,1,1,2,2,13075
1112,1112,2012-04-13,5,9,2,0,13075
1113,1113,2012-04-14,1,1,2,4,13079
1114,1114,2012-04-16,16,21,14,-13,13066
1115,1115,2012-04-18,10,21,1,6,13072
1116,1116,2012-04-19,9,11,8,16,13088
1117,1117,2012-04-20,19,19,23,42,13130
1118,1118,2012-04-21,1,1,2,-4,13126
1119,1119,2012-04-23,2,2,4,3,13129
1120,1120,2012-04-24,2,2,4,4,13133
1121,1121,2012-04-25,0,6,-4,-6,13127
1122,1122,2012-04-26,12,14,11,0,13127
1123,1123,2012-04-27,11,29,-4,2,13129
1124,1124,2012-04-29,1,2,1,-1,13128
1125,1125,2012-04-30,1,1,2,-2,13126
1126,1126,2012-05-01,2,2,3,3,13129
1127,1127,2012-05-02,2,3,4,-3,13126
1128,1128,2012-05-03,1,1,2,4,13130
1129,1129,2012-05-05,0,0,1,2,13132
1130,1130,2012-05-06,0,0,3,2,13134
1131,1131,2012-05-07,3,4,5,-4,13130
1132,1132,2012-05-08,2,3,4,2,13132
1133,1133,2012-05-09,0,0,2,1,13133
1134,1134,2012-05-10,1,1,3,6,13139
1135,1135,2012-05-11,0,0,3,3,13142
1136,1136,2012-05-12,3,3,6,6,13148
1137,1137,2012-05-13,1,1,2,4,13152
1138,1138,2012-05-14,0,0,2,4,13156
1139,1139,2012-05-15,4,5,8,-1,13155
1140,1140,2012-05-16,1,2,1,1,13156
1141,1141,2012-05-17,0,0,1,1,13157
1142,1142,2012-05-18,2,3,2,4,13161
1143,1143,2012-05-20,0,0,1,1,13162
1144,1144,2012-05-21,3,4,5,2,13164
1145,1145,2012-05-22,1,1,7,14,13178
1146,1146,2012-05-23,0,0,1,-2,13176
1147,1147,2012-05-28,1,2,2,4,13180
1148,1148,2012-05-29,2,2,5,6,13186
1149,1149,2012-05-30,0,0,1,1,13187
1150,1150,2012-06-01,0,0,3,2,13189
1151,1151,2012-06-02,1,1,2,4,13193
1152,1152,2012-06-03,0,0,1,1,13194
1153,1153,2012-06-04,15,20,15,-9,13185
1154,1154,2012-06-05,0,1,0,0,13185
1155,1155,2012-06-06,8,9,11,-7,13178
1156,1156,2012-06-07,0,0,2,2,13180
1157,1157,2012-06-09,1,1,3,-2,13178
1158,1158,2012-06-10,4,5,4,4,13182
1159,1159,2012-06-12,4,7,4,1,13183
1160,1160,2012-06-13,1,2,2,1,13184
1161,1161,2012-06-14,0,0,1,2,13186
1162,1162,2012-06-15,1,1,2,4,13190
1163,1163,2012-06-16,0,0,1,1,13191
1164,1164,2012-06-17,0,0,1,0,13191
1165,1165,2012-06-18,0,0,3,4,13195
1166,1166,2012-06-19,5,6,5,5,13200
1167,1167,2012-06-20,2,3,4,8,13208
1168,1168,2012-06-21,7,7,11,8,13216
1169,1169,2012-06-22,3,4,7,10,13226
1170,1170,2012-06-23,2,2,7,13,13239
1171,1171,2012-06-25,36,37,37,74,13313
1172,1172,2012-06-26,2,4,2,2,13315
1173,1173,2012-06-28,27,36,21,-32,13283
1174,1174,2012-07-01,27,28,29,-51,13232
1175,1175,2012-07-03,7,8,7,7,13239
1176,1176,2012-07-04,2,5,4,6,13245
1177,1177,2012-07-05,0,0,1,2,13247
1178,1178,2012-07-06,5,7,6,3,13250
1179,1179,2012-07-08,0,0,1,2,13252
1180,1180,2012-07-09,0,0,1,1,13253
1181,1181,2012-07-10,45,48,47,56,13309
1182,1182,2012-07-12,4,5,5,-8,13301
1183,1183,2012-07-13,0,0,2,4,13305
1184,1184,2012-07-14,4,6,3,-6,13299
1185,1185,2012-07-16,1,1,3,4,13303
1186,1186,2012-07-17,1,1,5,10,13313
1187,1187,2012-07-18,6,8,7,11,13324
1188,1188,2012-07-19,0,0,1,2,13326
1189,1189,2012-07-20,0,1,1,1,13327
1190,1190,2012-07-21,0,1,0,0,13327
1191,1191,2012-07-22,4,7,3,3,13330
1192,1192,2012-07-23,2,2,3,6,13336
1193,1193,2012-07-26,0,1,1,-2,13334
1194,1194,2012-07-27,0,0,1,-2,13332
1195,1195,2012-07-28,0,0,1,2,13334
1196,1196,2012-07-29,1,1,2,4,13338
1197,1197,2012-07-30,0,0,1,2,13340
1198,1198,2012-07-31,5,5,8,13,13353
1199,1199,2012-08-01,63,78,49,-98,13255
1200,1200,2012-08-02,1,2,1,0,13255
1201,1201,2012-08-03,0,0,1,2,13257
1202,1202,2012-08-04,1,1,2,0,13257
1203,1203,2012-08-05,1,1,4,8,13265
1204,1204,2012-08-06,2,2,6,6,13271
1205,1205,2012-08-07,3,4,5,-3,13268
1206,1206,2012-08-08,2,3,3,2,13270
1207,1207,2012-08-09,1,1,3,-4,13266
1208,1208,2012-08-11,1,1,2,4,13270
1209,1209,2012-08-12,0,0,1,-2,13268
1210,1210,2012-08-14,5,6,6,9,13277
1211,1211,2012-08-15,12,18,10,7,13284
1212,1212,2012-08-16,1,1,4,-1,13283
1213,1213,2012-08-17,7,7,10,17,13300
1214,1214,2012-08-18,0,0,2,2,13302
1215,1215,2012-08-19,1,1,2,-2,13300
1216,1216,2012-08-20,1,3,2,-1,13299
1217,1217,2012-08-21,23,24,25,50,13349
1218,1218,2012-08-22,6,9,5,-3,13346
1219,1219,2012-08-23,0,0,1,2,13348
1220,1220,2012-08-24,0,0,1,2,13350
1221,1221,2012-08-26,2,4,1,2,13352
1222,1222,2012-08-28,2,4,2,0,13352
1223,1223,2012-08-29,1,1,4,0,13352
1224,1224,2012-08-30,2,2,3,-6,13346
1225,1225,2012-09-01,1,2,3,-1,13345
1226,1226,2012-09-02,7,8,8,16,13361
1227,1227,2012-09-04,12,15,14,26,13387
1228,1228,2012-09-06,11,19,9,2,13389
1229,1229,2012-09-07,0,0,1,2,13391
1230,1230,2012-09-08,3,4,4,4,13395
1231,1231,2012-09-09,1,1,6,6,13401
1232,1232,2012-09-11,3,3,4,8,13409
1233,1233,2012-09-13,0,0,2,4,13413
1234,1234,2012-09-14,1,2,3,-2,13411
1235,1235,2012-09-15,0,0,2,3,13414
1236,1236,2012-09-16,2,2,5,6,13420
1237,1237,2012-09-17,0,0,1,2,13422
1238,1238,2012-09-18,6,8,9,-2,13420
1239,1239,2012-09-19,0,0,3,-4,13416
1240,1240,2012-09-20,4,4,7,-5,13411
1241,1241,2012-09-21,0,0,4,2,13413
1242,1242,2012-09-22,3,6,2,0,13413
1243,1243,2012-09-23,3,4,3,0,13413
1244,1244,2012-09-24,13,17,11,11,13424
1245,1245,2012-09-25,0,0,2,2,13426
1246,1246,2012-09-26,0,1,3,1,13427
1247,1247,2012-09-27,37,37,38,38,13465
1248,1248,2012-09-28,1,1,4,2,13467
1249,1249,2012-09-29,1,1,4,8,13475
1250,1250,2012-09-30,2,3,2,4,13479
1251,1251,2012-10-01,13,16,11,22,13501
1252,1252,2012-10-02,5,12,1,1,13502
1253,1253,2012-10-03,14,16,18,26,13528
1254,1254,2012-10-06,0,0,1,2,13530
1255,1255,2012-10-07,0,1,1,1,13531
1256,1256,2012-10-08,1,1,4,6,13537
1257,1257,2012-10-09,0,0,1,2,13539
1258,1258,2012-10-10,0,0,1,2,13541
1259,1259,2012-10-11,2,2,4,4,13545
1260,1260,2012-10-12,0,0,1,2,13547
1261,1261,2012-10-13,2,2,6,9,13556
1262,1262,2012-10-14,0,0,1,-2,13554
1263,1263,2012-10-15,4,5,5,4,13558
1264,1264,2012-10-16,4,4,6,3,13561
1265,1265,2012-10-17,7,8,9,-15,13546
1266,1266,2012-10-18,3,13,-1,19,13565
1267,1267,2012-10-19,0,0,1,2,13567
1268,1268,2012-10-20,0,0,2,3,13570
1269,1269,2012-10-21,12,12,13,-26,13544
1270,1270,2012-10-22,1,1,5,7,13551
1271,1271,2012-10-23,4,5,6,8,13559
1272,1272,2012-10-24,1,1,4,8,13567
1273,1273,2012-10-25,5,6,9,-4,13563
1274,1274,2012-10-27,0,0,1,2,13565
1275,1275,2012-10-28,20,23,20,40,13605
1276,1276,2012-10-29,3,3,5,6,13611
1277,1277,2012-10-31,0,0,3,6,13617
1278,1278,2012-11-01,20,23,19,-34,13583
1279,1279,2012-11-02,2,3,2,0,13583
1280,1280,2012-11-03,5,6,5,10,13593
1281,1281,2012-11-04,2,2,5,-2,13591
1282,1282,2012-11-05,19,22,17,0,13591
1283,1283,2012-11-06,0,0,1,2,13593
1284,1284,2012-11-07,15,25,9,-14,13579
1285,1285,2012-11-08,13,18,11,5,13584
1286,1286,2012-11-10,0,1,0,0,13584
1287,1287,2012-11-11,0,0,1,2,13586
1288,1288,2012-11-12,0,0,2,4,13590
1289,1289,2012-11-13,0,0,4,0,13590
1290,1290,2012-11-14,0,0,1,2,13592
1291,1291,2012-11-15,5,5,9,10,13602
1292,1292,2012-11-16,4,5,9,3,13605
1293,1293,2012-11-17,0,0,1,1,13606
1294,1294,2012-11-18,0,0,2,3,13609
1295,1295,2012-11-19,4,5,10,8,13617
1296,1296,2012-11-20,18,23,15,0,13617
1297,1297,2012-11-21,12,14,14,-18,13599
1298,1298,2012-11-22,1,2,3,5,13604
1299,1299,2012-11-23,1,1,3,6,13610
1300,1300,2012-11-24,1,1,6,12,13622
1301,1301,2012-11-25,4,4,8,10,13632
1302,1302,2012-11-26,0,0,8,12,13644
1303,1303,2012-11-27,4,4,13,16,13660
1304,1304,2012-11-28,1,8,-3,9,13669
1305,1305,2012-11-29,2,4,5,5,13674
1306,1306,2012-11-30,1,2,2,3,13677
1307,1307,2012-12-01,4,5,10,15,13692
1308,1308,2012-12-02,5,5,9,18,13710
1309,1309,2012-12-03,15,17,18,40,13750
1310,1310,2012-12-04,17,18,25,38,13788
1311,1311,2012-12-05,25,32,27,54,13842
1312,1312,2012-12-06,3,4,9,5,13847
1313,1313,2012-12-07,2,2,7,6,13853
1314,1314,2012-12-08,8,9,15,-4,13849
1315,1315,2012-12-09,0,0,1,2,13851
1316,1316,2012-12-10,10,10,18,33,13884
1317,1317,2012-12-11,0,0,6,10,13894
1318,1318,2012-12-12,11,14,16,4,13898
1319,1319,2012-12-13,0,2,4,7,13905
1320,1320,2012-12-14,1,1,2,4,13909
1321,1321,2012-12-15,2,2,8,13,13922
1322,1322,2012-12-16,0,1,3,5,13927
1323,1323,2012-12-17,1,1,3,6,13933
1324,1324,2012-12-18,2,2,6,8,13941
1325,1325,2012-12-19,0,0,6,11,13952
1326,1326,2012-12-20,4,5,11,19,13971
1327,1327,2012-12-21,4,7,8,6,13977
1328,1328,2012-12-22,13,18,12,-12,13965
1329,1329,2012-12-23,1,1,9,14,13979
1330,1330,2012-12-24,0,0,1,2,13981
1331,1331,2012-12-25,0,0,5,7,13988
1332,1332,2012-12-26,26,34,24,2,13990
1333,1333,2012-12-27,2,3,8,12,14002
1334,1334,2012-12-28,10,13,22,3,14005
1335,1335,2012-12-29,8,11,16,22,14027
1336,1336,2012-12-30,9,18,13,24,14051
1337,1337,2012-12-31,3,6,13,14,14065
1338,1338,2013-01-01,12,14,20,29,14094
1339,1339,2013-01-02,10,13,21,33,14127
1340,1340,2013-01-03,1,2,6,9,14136
1341,1341,2013-01-04,0,0,9,17,14153
1342,1342,2013-01-05,4,4,10,14,14167
1343,1343,2013-01-06,34,36,46,52,14219
1344,1344,2013-01-07,3,7,6,8,14227
1345,1345,2013-01-08,1,1,11,18,14245
1346,1346,2013-01-09,25,29,35,45,14290
1347,1347,2013-01-10,2,3,10,15,14305
1348,1348,2013-01-11,66,76,61,119,14424
1349,1349,2013-01-12,2,3,9,8,14432
1350,1350,2013-01-13,0,0,4,8,14440
1351,1351,2013-01-14,20,36,19,-5,14435
1352,1352,2013-01-15,17,19,26,35,14470
1353,1353,2013-01-16,0,0,3,4,14474
1354,1354,2013-01-17,0,0,7,12,14486
1355,1355,2013-01-18,0,0,2,1,14487
1356,1356,2013-01-19,7,10,12,14,14501
1357,1357,2013-01-20,46,50,50,45,14546
1358,1358,2013-01-21,2,3,12,14,14560
1359,1359,2013-01-22,3,4,6,0,14560
1360,1360,2013-01-23,32,40,33,12,14572
1361,1361,2013-01-24,5,6,9,12,14584
1362,1362,2013-01-25,9,10,12,17,14601
1363,1363,2013-01-26,36,39,42,38,14639
1364,1364,2013-01-27,1,1,10,14,14653
1365,1365,2013-01-28,16,20,23,39,14692
1366,1366,2013-01-29,0,0,1,1,14693
1367,1367,2013-01-30,10,11,19,19,14712
1368,1368,2013-01-31,0,0,4,6,14718
1369,1369,2013-02-01,26,29,32,62,14780
1370,1370,2013-02-02,1,1,5,1,14781
1371,1371,2013-02-03,7,8,9,18,14799
1372,1372,2013-02-04,3,3,13,21,14820
1373,1373,2013-02-05,18,18,24,48,14868
1374,1374,2013-02-06,6,8,15,22,14890
1375,1375,2013-02-07,2,2,5,7,14897
1376,1376,2013-02-08,1,1,6,12,14909
1377,1377,2013-02-09,1,1,5,10,14919
1378,1378,2013-02-10,29,30,36,56,14975
1379,1379,2013-02-11,10,10,14,22,14997
1380,1380,2013-02-12,1,2,3,6,15003
1381,1381,2013-02-13,2,2,9,12,15015
1382,1382,2013-02-14,3,4,8,8,15023
1383,1383,2013-02-15,13,14,18,33,15056
1384,1384,2013-02-16,0,0,3,6,15062
1385,1385,2013-02-17,1,2,5,6,15068
1386,1386,2013-02-18,84,92,83,148,15216
1387,1387,2013-02-19,16,26,21,13,15229
1388,1388,2013-02-20,1,1,7,12,15241
1389,1389,2013-02-21,5,11,8,4,15245
1390,1390,2013-02-22,7,10,13,12,15257
1391,1391,2013-02-23,1,1,8,8,15265
1392,1392,2013-02-24,9,11,14,-4,15261
1393,1393,2013-02-25,36,40,44,44,15305
1394,1394,2013-02-26,1,1,5,6,15311
1395,1395,2013-02-27,2,11,0,-4,15307
1396,1396,2013-02-28,61,69,62,-99,15208
1397,1397,2013-03-01,0,0,1,2,15210
1398,1398,2013-03-02,2,3,8,14,15224
1399,1399,2013-03-03,6,11,9,13,15237
1400,1400,2013-03-04,1,2,6,7,15244
1401,1401,2013-03-05,2,2,5,-4,15240
1402,1402,2013-03-06,1,1,8,11,15251
1403,1403,2013-03-07,2,3,7,12,15263
1404,1404,2013-03-08,2,3,3,6,15269
1405,1405,2013-03-09,7,8,13,16,15285
1406,1406,2013-03-10,21,22,28,54,15339
1407,1407,2013-03-11,17,19,28,44,15383
1408,1408,2013-03-12,1,1,2,4,15387
1409,1409,2013-03-13,18,21,21,38,15425
1410,1410,2013-03-14,1,3,6,2,15427
1411,1411,2013-03-15,5,7,6,8,15435
1412,1412,2013-03-16,4,5,13,23,15458
1413,1413,2013-03-17,1,1,9,14,15472
1414,1414,2013-03-18,2,3,4,1,15473
1415,1415,2013-03-19,20,26,18,31,15504
1416,1416,2013-03-20,5,12,9,20,15524
1417,1417,2013-03-21,3,4,8,2,15526
1418,1418,2013-03-22,1,1,6,4,15530
1419,1419,2013-03-23,5,6,7,14,15544
1420,1420,2013-03-24,60,66,58,61,15605
1421,1421,2013-03-25,36,40,40,76,15681
1422,1422,2013-03-26,4,4,13,11,15692
1423,1423,2013-03-27,13,13,17,6,15698
1424,1424,2013-03-28,6,6,12,24,15722
1425,1425,2013-03-29,26,28,32,59,15781
1426,1426,2013-03-30,0,0,5,8,15789
1427,1427,2013-04-01,1,1,2,4,15793
1428,1428,2013-04-02,20,27,23,37,15830
1429,1429,2013-04-03,13,16,22,17,15847
1430,1430,2013-04-04,49,55,44,0,15847
1431,1431,2013-04-05,13,28,7,18,15865
1432,1432,2013-04-06,13,13,17,31,15896
1433,1433,2013-04-07,14,16,15,18,15914
1434,1434,2013-04-08,7,11,11,14,15928
1435,1435,2013-04-09,5,5,10,11,15939
1436,1436,2013-04-10,0,0,1,1,15940
1437,1437,2013-04-11,27,29,33,57,15997
1438,1438,2013-04-12,6,8,8,11,16008
1439,1439,2013-04-13,5,7,11,14,16022
1440,1440,2013-04-14,6,8,11,11,16033
1441,1441,2013-04-15,34,39,33,-59,15974
1442,1442,2013-04-16,6,7,12,15,15989
1443,1443,2013-04-17,2,4,10,6,15995
1444,1444,2013-04-18,15,18,20,-16,15979
1445,1445,2013-04-19,1,1,5,9,15988
1446,1446,2013-04-20,1,1,5,2,15990
1447,1447,2013-04-21,10,11,13,25,16015
1448,1448,2013-04-22,1,1,5,10,16025
1449,1449,2013-04-23,3,7,6,11,16036
1450,1450,2013-04-24,12,17,12,14,16050
1451,1451,2013-04-25,0,1,6,8,16058
1452,1452,2013-04-26,0,0,2,3,16061
1453,1453,2013-04-27,4,4,7,10,16071
1454,1454,2013-04-28,1,3,3,1,16072
1455,1455,2013-04-29,15,17,18,36,16108
1456,1456,2013-04-30,9,11,20,28,16136
1457,1457,2013-05-01,3,7,7,18,16154
1458,1458,2013-05-02,6,8,8,-4,16150
1459,1459,2013-05-03,8,9,11,21,16171
1460,1460,2013-05-04,3,4,6,6,16177
1461,1461,2013-05-05,6,7,14,6,16183
1462,1462,2013-05-06,27,32,31,40,16223
1463,1463,2013-05-07,0,0,4,3,16226
1464,1464,2013-05-08,2,3,5,9,16235
1465,1465,2013-05-09,13,18,17,29,16264
1466,1466,2013-05-10,0,0,5,6,16270
1467,1467,2013-05-11,6,7,10,20,16290
1468,1468,2013-05-12,4,4,8,12,16302
1469,1469,2013-05-13,16,29,13,28,16330
1470,1470,2013-05-14,4,6,10,10,16340
1471,1471,2013-05-15,1,1,7,12,16352
1472,1472,2013-05-16,7,8,12,20,16372
1473,1473,2013-05-17,4,4,7,7,16379
1474,1474,2013-05-18,5,10,4,2,16381
1475,1475,2013-05-19,1,1,5,0,16381
1476,1476,2013-05-20,11,14,14,-13,16368
1477,1477,2013-05-21,7,8,11,18,16386
1478,1478,2013-05-22,36,38,43,68,16454
1479,1479,2013-05-23,1,2,4,4,16458
1480,1480,2013-05-24,11,17,13,-3,16455
1481,1481,2013-05-25,33,43,34,-14,16441
1482,1482,2013-05-26,2,2,8,13,16454
1483,1483,2013-05-27,1,1,3,6,16460
1484,1484,2013-05-28,17,21,23,1,16461
1485,1485,2013-05-29,0,0,2,2,16463
1486,1486,2013-05-30,4,5,8,-4,16459
1487,1487,2013-05-31,19,21,25,45,16504
1488,1488,2013-06-01,0,0,3,3,16507
1489,1489,2013-06-02,14,15,18,-17,16490
1490,1490,2013-06-03,1,3,5,5,16495
1491,1491,2013-06-04,26,30,24,48,16543
1492,1492,2013-06-05,156,163,154,157,16700
1493,1493,2013-06-06,2,2,5,8,16708
1494,1494,2013-06-07,0,1,1,2,16710
1495,1495,2013-06-08,25,26,26,52,16762
1496,1496,2013-06-09,0,0,3,3,16765
1497,1497,2013-06-10,9,12,14,18,16783
1498,1498,2013-06-11,39,40,46,88,16871
1499,1499,2013-06-12,0,0,3,6,16877
1500,1500,2013-06-13,0,0,4,7,16884
1501,1501,2013-06-14,9,9,16,26,16910
1502,1502,2013-06-15,4,4,10,19,16929
1503,1503,2013-06-16,0,0,4,7,16936
1504,1504,2013-06-17,6,7,15,10,16946
1505,1505,2013-06-18,4,6,11,15,16961
1506,1506,2013-06-20,7,9,15,19,16980
1507,1507,2013-06-21,2,2,6,12,16992
1508,1508,2013-06-22,1,1,6,8,17000
1509,1509,2013-06-23,2,2,6,-6,16994
1510,1510,2013-06-24,1,1,6,2,16996
1511,1511,2013-06-25,7,9,13,21,17017
1512,1512,2013-06-26,1,1,4,4,17021
1513,1513,2013-06-27,2,3,9,6,17027
1514,1514,2013-06-28,7,10,11,-1,17026
1515,1515,2013-06-29,4,7,8,2,17028
1516,1516,2013-06-30,0,0,6,9,17037
1517,1517,2013-07-01,1,1,4,6,17043
1518,1518,2013-07-02,1,1,3,-1,17042
1519,1519,2013-07-03,2,5,2,3,17045
1520,1520,2013-07-04,1,1,4,-2,17043
1521,1521,2013-07-05,7,8,13,14,17057
1522,1522,2013-07-07,7,8,15,25,17082
1523,1523,2013-07-08,4,6,11,17,17099
1524,1524,2013-07-09,13,16,18,32,17131
1525,1525,2013-07-10,3,4,9,-1,17130
1526,1526,2013-07-11,2,2,7,11,17141
1527,1527,2013-07-12,3,3,8,14,17155
1528,1528,2013-07-13,1,2,3,3,17158
1529,1529,2013-07-14,2,5,3,5,17163
1530,1530,2013-07-15,1,1,5,6,17169
1531,1531,2013-07-16,0,0,4,5,17174
1532,1532,2013-07-17,1,2,4,4,17178
1533,1533,2013-07-18,1,1,3,0,17178
1534,1534,2013-07-19,7,7,9,-6,17172
1535,1535,2013-07-20,1,1,6,7,17179
1536,1536,2013-07-21,2,2,8,4,17183
1537,1537,2013-07-22,6,7,12,0,17183
1538,1538,2013-07-23,0,0,2,3,17186
1539,1539,2013-07-24,1,1,4,7,17193
1540,1540,2013-07-25,4,5,7,-1,17192
1541,1541,2013-07-26,17,19,20,36,17228
1542,1542,2013-07-27,0,0,2,3,17231
1543,1543,2013-07-28,4,6,5,-2,17229
1544,1544,2013-07-29,3,4,8,3,17232
1545,1545,2013-07-30,0,0,4,3,17235
1546,1546,2013-07-31,1,3,4,3,17238
1547,1547,2013-08-01,6,8,10,0,17238
1548,1548,2013-08-02,3,6,9,14,17252
1549,1549,2013-08-03,11,14,14,12,17264
1550,1550,2013-08-04,0,0,5,3,17267
1551,1551,2013-08-05,0,0,3,6,17273
1552,1552,2013-08-06,0,0,5,8,17281
1553,1553,2013-08-07,17,19,18,36,17317
1554,1554,2013-08-08,1,2,4,7,17324
1555,1555,2013-08-09,9,14,12,22,17346
1556,1556,2013-08-10,2,2,5,1,17347
1557,1557,2013-08-11,3,3,7,9,17356
1558,1558,2013-08-12,2,2,4,1,17357
1559,1559,2013-08-13,1,2,6,10,17367
1560,1560,2013-08-14,0,0,2,3,17370
1561,1561,2013-08-15,0,0,5,8,17378
1562,1562,2013-08-16,0,0,5,4,17382
1563,1563,2013-08-17,3,5,5,2,17384
1564,1564,2013-08-18,4,4,12,4,17388
1565,1565,2013-08-19,3,3,6,-1,17387
1566,1566,2013-08-20,25,32,25,42,17429
1567,1567,2013-08-21,8,9,10,20,17449
1568,1568,2013-08-22,5,5,10,13,17462
1569,1569,2013-08-23,4,4,12,17,17479
1570,1570,2013-08-24,15,17,18,4,17483
1571,1571,2013-08-25,3,5,7,10,17493
1572,1572,2013-08-26,4,5,6,3,17496
1573,1573,2013-08-27,16,22,20,52,17548
1574,1574,2013-08-28,2,4,3,6,17554
1575,1575,2013-08-29,2,4,3,4,17558
1576,1576,2013-08-30,0,0,1,-2,17556
1577,1577,2013-08-31,19,21,22,-11,17545
1578,1578,2013-09-01,0,1,2,0,17545
1579,1579,2013-09-02,1,1,5,8,17553
1580,1580,2013-09-03,1,1,8,10,17563
1581,1581,2013-09-04,3,4,5,10,17573
1582,1582,2013-09-05,16,19,16,-24,17549
1583,1583,2013-09-06,0,0,4,0,17549
1584,1584,2013-09-07,5,5,8,10,17559
1585,1585,2013-09-08,4,5,7,4,17563
1586,1586,2013-09-09,1,2,3,5,17568
1587,1587,2013-09-10,1,1,7,13,17581
1588,1588,2013-09-11,5,5,11,22,17603
1589,1589,2013-09-12,1,1,3,6,17609
1590,1590,2013-09-13,23,31,24,-8,17601
1591,1591,2013-09-14,7,10,8,16,17617
1592,1592,2013-09-15,2,3,4,3,17620
1593,1593,2013-09-16,0,0,2,4,17624
1594,1594,2013-09-17,5,6,10,12,17636
1595,1595,2013-09-18,2,2,13,6,17642
1596,1596,2013-09-19,4,5,9,15,17657
1597,1597,2013-09-20,7,7,11,19,17676
1598,1598,2013-09-21,2,2,11,13,17689
1599,1599,2013-09-22,1,1,6,8,17697
1600,1600,2013-09-23,20,26,21,-4,17693
1601,1601,2013-09-24,0,0,6,5,17698
1602,1602,2013-09-25,6,9,9,13,17711
1603,1603,2013-09-26,2,4,4,4,17715
1604,1604,2013-09-27,0,1,4,7,17722
1605,1605,2013-09-28,0,0,2,2,17724
1606,1606,2013-09-29,2,3,3,0,17724
1607,1607,2013-09-30,2,3,4,7,17731
1608,1608,2013-10-01,1,1,3,-1,17730
1609,1609,2013-10-02,0,2,9,15,17745
1610,1610,2013-10-03,0,0,6,10,17755
1611,1611,2013-10-04,12,15,14,15,17770
1612,1612,2013-10-05,1,1,5,8,17778
1613,1613,2013-10-06,0,0,2,4,17782
1614,1614,2013-10-07,11,18,14,15,17797
1615,1615,2013-10-08,2,3,6,1,17798
1616,1616,2013-10-09,3,4,8,11,17809
1617,1617,2013-10-10,1,1,6,4,17813
1618,1618,2013-10-11,3,6,4,5,17818
1619,1619,2013-10-12,3,4,5,0,17818
1620,1620,2013-10-13,5,6,11,16,17834
1621,1621,2013-10-14,1,2,6,9,17843
1622,1622,2013-10-15,1,2,5,9,17852
1623,1623,2013-10-16,2,5,7,10,17862
1624,1624,2013-10-17,6,9,16,16,17878
1625,1625,2013-10-18,1,5,2,4,17882
1626,1626,2013-10-19,2,2,8,-1,17881
1627,1627,2013-10-20,4,4,12,20,17901
1628,1628,2013-10-21,3,5,12,14,17915
1629,1629,2013-10-22,1,1,9,17,17932
1630,1630,2013-10-23,0,1,6,8,17940
1631,1631,2013-10-24,0,1,5,5,17945
1632,1632,2013-10-25,2,2,11,8,17953
1633,1633,2013-10-26,24,26,27,46,17999
1634,1634,2013-10-27,1,1,11,12,18011
1635,1635,2013-10-28,2,3,8,16,18027
1636,1636,2013-10-29,9,10,14,19,18046
1637,1637,2013-10-30,5,7,7,12,18058
1638,1638,2013-10-31,0,1,2,3,18061
1639,1639,2013-11-01,9,10,12,-16,18045
1640,1640,2013-11-02,0,0,7,7,18052
1641,1641,2013-11-03,7,8,11,21,18073
1642,1642,2013-11-04,1,3,3,1,18074
1643,1643,2013-11-05,25,28,30,34,18108
1644,1644,2013-11-06,7,9,11,8,18116
1645,1645,2013-11-07,0,0,2,3,18119
1646,1646,2013-11-08,1,1,5,8,18127
1647,1647,2013-11-09,2,2,11,18,18145
1648,1648,2013-11-10,4,4,12,-3,18142
1649,1649,2013-11-11,19,24,23,17,18159
1650,1650,2013-11-12,0,0,2,4,18163
1651,1651,2013-11-13,3,4,8,0,18163
1652,1652,2013-11-14,5,5,11,-6,18157
1653,1653,2013-11-15,7,9,10,17,18174
1654,1654,2013-11-16,0,0,4,8,18182
1655,1655,2013-11-17,4,8,5,0,18182
1656,1656,2013-11-18,0,0,2,-1,18181
1657,1657,2013-11-19,0,0,7,7,18188
1658,1658,2013-11-20,0,0,4,4,18192
1659,1659,2013-11-21,10,11,18,9,18201
1660,1660,2013-11-22,4,5,9,15,18216
1661,1661,2013-11-23,4,4,15,15,18231
1662,1662,2013-11-24,0,0,3,4,18235
1663,1663,2013-11-25,2,2,5,8,18243
1664,1664,2013-11-26,1,3,7,4,18247
1665,1665,2013-11-27,1,1,5,5,18252
1666,1666,2013-11-28,3,4,7,5,18257
1667,1667,2013-11-29,7,7,12,21,18278
1668,1668,2013-11-30,2,3,8,9,18287
1669,1669,2013-12-01,2,2,12,14,18301
1670,1670,2013-12-02,9,11,20,25,18326
1671,1671,2013-12-03,4,6,10,17,18343
1672,1672,2013-12-04,0,0,3,6,18349
1673,1673,2013-12-05,16,19,20,-20,18329
1674,1674,2013-12-06,7,9,17,-2,18327
1675,1675,2013-12-07,4,5,12,22,18349
1676,1676,2013-12-08,4,4,12,11,18360
1677,1677,2013-12-09,14,17,19,30,18390
1678,1678,2013-12-10,7,7,11,16,18406
1679,1679,2013-12-11,6,8,16,18,18424
1680,1680,2013-12-12,7,9,12,18,18442
1681,1681,2013-12-13,22,26,22,-35,18407
1682,1682,2013-12-14,1,1,3,3,18410
1683,1683,2013-12-15,2,4,6,7,18417
1684,1684,2013-12-16,4,8,12,7,18424
1685,1685,2013-12-17,12,13,22,31,18455
1686,1686,2013-12-18,4,4,14,26,18481
1687,1687,2013-12-19,2,3,8,4,18485
1688,1688,2013-12-20,23,23,30,56,18541
1689,1689,2013-12-21,0,0,6,6,18547
1690,1690,2013-12-22,0,1,1,1,18548
1691,1691,2013-12-23,0,0,6,9,18557
1692,1692,2013-12-24,3,4,8,6,18563
1693,1693,2013-12-25,0,1,3,1,18564
1694,1694,2013-12-26,4,5,6,0,18564
1695,1695,2013-12-27,7,24,5,52,18616
1696,1696,2013-12-28,0,1,3,4,18620
1697,1697,2013-12-29,2,3,8,10,18630
1698,1698,2013-12-30,6,8,16,20,18650
1699,1699,2013-12-31,1,1,5,10,18660
1700,1700,2014-01-01,12,18,20,42,18702
1701,1701,2014-01-02,4,5,13,24,18726
1702,1702,2014-01-03,9,10,17,28,18754
1703,1703,2014-01-04,16,19,26,13,18767
1704,1704,2014-01-05,13,19,22,37,18804
1705,1705,2014-01-06,1,1,10,18,18822
1706,1706,2014-01-07,4,8,13,17,18839
1707,1707,2014-01-08,3,3,15,22,18861
1708,1708,2014-01-09,1,2,6,9,18870
1709,1709,2014-01-10,7,9,15,-6,18864
1710,1710,2014-01-11,4,6,8,0,18864
1711,1711,2014-01-12,7,7,17,31,18895
1712,1712,2014-01-13,4,7,11,20,18915
1713,1713,2014-01-14,41,42,51,79,18994
1714,1714,2014-01-15,9,11,18,-4,18990
1715,1715,2014-01-16,4,10,6,11,19001
1716,1716,2014-01-17,2,4,12,20,19021
1717,1717,2014-01-18,6,11,6,6,19027
1718,1718,2014-01-19,0,0,5,7,19034
1719,1719,2014-01-20,0,1,3,3,19037
1720,1720,2014-01-21,3,4,5,6,19043
1721,1721,2014-01-22,10,13,16,24,19067
1722,1722,2014-01-23,0,0,4,7,19074
1723,1723,2014-01-24,3,9,2,-2,19072
1724,1724,2014-01-25,2,3,5,5,19077
1725,1725,2014-01-26,3,7,4,5,19082
1726,1726,2014-01-27,215,222,212,417,19499
1727,1727,2014-01-28,6,12,8,-3,19496
1728,1728,2014-01-29,1,1,9,8,19504
1729,1729,2014-01-30,1,3,3,5,19509
1730,1730,2014-01-31,4,4,9,7,19516
1731,1731,2014-02-01,1,1,7,3,19519
1732,1732,2014-02-02,3,3,9,14,19533
1733,1733,2014-02-03,6,7,14,2,19535
1734,1734,2014-02-04,3,4,10,12,19547
1735,1735,2014-02-05,6,6,15,23,19570
1736,1736,2014-02-06,4,5,9,2,19572
1737,1737,2014-02-07,2,3,6,6,19578
1738,1738,2014-02-08,39,41,44,-61,19517
1739,1739,2014-02-09,3,4,12,23,19540
1740,1740,2014-02-10,10,14,9,-3,19537
1741,1741,2014-02-11,6,12,6,3,19540
1742,1742,2014-02-12,1,2,5,8,19548
1743,1743,2014-02-13,1,3,5,11,19559
1744,1744,2014-02-14,16,22,21,33,19592
1745,1745,2014-02-15,0,1,4,6,19598
1746,1746,2014-02-16,2,3,9,13,19611
1747,1747,2014-02-17,1,1,8,4,19615
1748,1748,2014-02-18,6,6,17,18,19633
1749,1749,2014-02-19,8,10,18,12,19645
1750,1750,2014-02-20,0,1,5,10,19655
1751,1751,2014-02-21,0,0,2,4,19659
1752,1752,2014-02-22,85,88,88,164,19823
1753,1753,2014-02-23,1,1,3,6,19829
1754,1754,2014-02-24,4,5,10,5,19834
1755,1755,2014-02-25,13,16,18,19,19853
1756,1756,2014-02-26,20,25,24,33,19886
1757,1757,2014-02-27,9,11,19,33,19919
1758,1758,2014-02-28,8,14,4,1,19920
1759,1759,2014-03-01,2,4,13,22,19942
1760,1760,2014-03-02,8,11,16,14,19956
1761,1761,2014-03-03,32,39,39,-28,19928
1762,1762,2014-03-04,3,4,13,22,19950
1763,1763,2014-03-05,6,7,14,15,19965
1764,1764,2014-03-06,15,17,23,17,19982
1765,1765,2014-03-07,2,2,11,21,20003
1766,1766,2014-03-08,7,7,15,12,20015
1767,1767,2014-03-09,0,0,1,2,20017
1768,1768,2014-03-10,4,4,13,15,20032
1769,1769,2014-03-11,10,13,19,23,20055
1770,1770,2014-03-12,23,25,27,29,20084
1771,1771,2014-03-13,8,10,24,27,20111
1772,1772,2014-03-14,5,7,10,13,20124
1773,1773,2014-03-15,10,13,15,29,20153
1774,1774,2014-03-16,2,2,6,2,20155
1775,1775,2014-03-17,3,3,8,-3,20152
1776,1776,2014-03-18,12,15,19,-2,20150
1777,1777,2014-03-19,4,6,11,14,20164
1778,1778,2014-03-20,1,1,5,5,20169
1779,1779,2014-03-21,5,5,10,10,20179
1780,1780,2014-03-22,4,5,7,11,20190
1781,1781,2014-03-23,0,4,4,11,20201
1782,1782,2014-03-24,6,11,10,19,20220
1783,1783,2014-03-25,1,2,8,4,20224
1784,1784,2014-03-26,12,13,21,23,20247
1785,1785,2014-03-27,2,2,9,16,20263
1786,1786,2014-03-28,1,1,5,7,20270
1787,1787,2014-03-29,0,0,5,8,20278
1788,1788,2014-03-30,0,0,5,6,20284
1789,1789,2014-03-31,4,7,12,18,20302
1790,1790,2014-04-01,6,7,16,14,20316
1791,1791,2014-04-02,3,5,11,6,20322
1792,1792,2014-04-03,4,5,11,17,20339
1793,1793,2014-04-04,1,1,6,7,20346
1794,1794,2014-04-05,1,4,2,6,20352
1795,1795,2014-04-06,0,1,4,4,20356
1796,1796,2014-04-07,0,0,4,6,20362
1797,1797,2014-04-08,3,4,9,11,20373
1798,1798,2014-04-09,2,2,7,11,20384
1799,1799,2014-04-10,0,0,5,9,20393
1800,1800,2014-04-11,13,15,21,-2,20391
1801,1801,2014-04-12,4,6,8,10,20401
1802,1802,2014-04-13,8,8,12,0,20401
1803,1803,2014-04-14,4,6,7,13,20414
1804,1804,2014-04-15,9,11,15,2,20416
1805,1805,2014-04-16,11,16,16,9,20425
1806,1806,2014-04-17,3,3,12,3,20428
1807,1807,2014-04-18,6,8,15,22,20450
1808,1808,2014-04-19,1,1,3,4,20454
1809,1809,2014-04-20,0,0,2,4,20458
1810,1810,2014-04-21,0,1,1,2,20460
1811,1811,2014-04-22,0,0,5,10,20470
1812,1812,2014-04-23,6,7,11,6,20476
1813,1813,2014-04-24,25,27,33,41,20517
1814,1814,2014-04-25,6,8,11,19,20536
1815,1815,2014-04-27,34,42,34,62,20598
1816,1816,2014-04-28,3,3,10,12,20610
1817,1817,2014-04-29,2,2,9,11,20621
1818,1818,2014-04-30,2,4,5,3,20624
1819,1819,2014-05-01,52,56,59,26,20650
1820,1820,2014-05-02,0,1,7,14,20664
1821,1821,2014-05-03,4,6,6,10,20674
1822,1822,2014-05-04,3,4,9,2,20676
1823,1823,2014-05-05,0,0,3,5,20681
1824,1824,2014-05-06,0,0,5,10,20691
1825,1825,2014-05-07,7,7,18,33,20724
1826,1826,2014-05-08,1,1,7,9,20733
1827,1827,2014-05-09,8,9,16,23,20756
1828,1828,2014-05-10,229,235,230,241,20997
1829,1829,2014-05-11,0,0,2,3,21000
1830,1830,2014-05-12,0,0,5,9,21009
1831,1831,2014-05-13,9,10,16,-5,21004
1832,1832,2014-05-14,8,8,17,20,21024
1833,1833,2014-05-15,0,0,6,9,21033
1834,1834,2014-05-16,1,2,7,9,21042
1835,1835,2014-05-17,4,4,7,-2,21040
1836,1836,2014-05-18,5,5,11,4,21044
1837,1837,2014-05-19,2,6,9,13,21057
1838,1838,2014-05-20,1,1,9,15,21072
1839,1839,2014-05-21,0,1,2,3,21075
1840,1840,2014-05-22,1,1,8,9,21084
1841,1841,2014-05-23,9,12,17,19,21103
1842,1842,2014-05-24,11,12,15,25,21128
1843,1843,2014-05-25,2,2,5,4,21132
1844,1844,2014-05-26,0,0,5,9,21141
1845,1845,2014-05-27,8,17,4,28,21169
1846,1846,2014-05-28,0,1,7,6,21175
1847,1847,2014-05-29,9,9,20,18,21193
1848,1848,2014-05-30,0,0,4,2,21195
1849,1849,2014-05-31,1,1,6,12,21207
1850,1850,2014-06-01,0,0,1,1,21208
1851,1851,2014-06-02,0,0,3,6,21214
1852,1852,2014-06-03,11,16,12,-3,21211
1853,1853,2014-06-04,8,9,12,12,21223
1854,1854,2014-06-05,1,1,6,8,21231
1855,1855,2014-06-06,20,25,22,-9,21222
1856,1856,2014-06-07,2,10,3,29,21251
1857,1857,2014-06-08,0,0,6,10,21261
1858,1858,2014-06-09,98,106,101,-118,21143
1859,1859,2014-06-10,0,0,7,7,21150
1860,1860,2014-06-11,4,4,7,2,21152
1861,1861,2014-06-12,5,5,10,15,21167
1862,1862,2014-06-13,2,3,5,10,21177
1863,1863,2014-06-14,4,4,10,18,21195
1864,1864,2014-06-15,4,5,9,8,21203
1865,1865,2014-06-16,3,4,13,10,21213
1866,1866,2014-06-17,3,6,13,21,21234
1867,1867,2014-06-18,1,1,10,18,21252
1868,1868,2014-06-19,11,13,15,12,21264
1869,1869,2014-06-20,1,1,7,13,21277
1870,1870,2014-06-21,0,0,2,3,21280
1871,1871,2014-06-22,22,24,23,-20,21260
1872,1872,2014-06-23,1,2,6,3,21263
1873,1873,2014-06-24,16,16,23,-22,21241
1874,1874,2014-06-25,3,5,12,4,21245
1875,1875,2014-06-26,3,6,8,8,21253
1876,1876,2014-06-27,3,3,9,11,21264
1877,1877,2014-06-28,5,6,13,8,21272
1878,1878,2014-06-29,2,3,10,15,21287
1879,1879,2014-06-30,2,3,8,8,21295
1880,1880,2014-07-01,0,0,6,10,21305
1881,1881,2014-07-02,0,0,5,6,21311
1882,1882,2014-07-03,7,7,18,9,21320
1883,1883,2014-07-04,1,2,5,6,21326
1884,1884,2014-07-05,0,0,7,11,21337
1885,1885,2014-07-06,1,1,7,11,21348
1886,1886,2014-07-07,5,6,16,2,21350
1887,1887,2014-07-08,1,2,8,9,21359
1888,1888,2014-07-09,14,17,26,-8,21351
1889,1889,2014-07-10,17,22,20,-6,21345
1890,1890,2014-07-11,3,3,16,16,21361
1891,1891,2014-07-12,19,20,30,48,21409
1892,1892,2014-07-13,1,1,9,10,21419
1893,1893,2014-07-14,1,3,13,22,21441
1894,1894,2014-07-15,8,9,17,-5,21436
1895,1895,2014-07-16,1,1,10,11,21447
1896,1896,2014-07-17,0,0,3,4,21451
1897,1897,2014-07-18,3,5,12,8,21459
1898,1898,2014-07-19,13,17,22,6,21465
1899,1899,2014-07-20,7,14,14,-2,21463
1900,1900,2014-07-21,55,58,65,113,21576
1901,1901,2014-07-22,3,7,7,12,21588
1902,1902,2014-07-23,1,1,11,16,21604
1903,1903,2014-07-24,21,24,31,-3,21601
1904,1904,2014-07-25,15,16,26,-11,21590
1905,1905,2014-07-26,6,7,15,3,21593
1906,1906,2014-07-27,11,13,19,30,21623
1907,1907,2014-07-28,1,3,7,4,21627
1908,1908,2014-07-29,2,4,6,-1,21626
1909,1909,2014-07-30,7,8,18,17,21643
1910,1910,2014-07-31,1,2,10,16,21659
1911,1911,2014-08-01,3,3,12,18,21677
1912,1912,2014-08-02,2,2,8,11,21688
1913,1913,2014-08-03,5,6,11,11,21699
1914,1914,2014-08-04,1,2,6,5,21704
1915,1915,2014-08-05,2,3,9,11,21715
1916,1916,2014-08-06,5,6,15,16,21731
1917,1917,2014-08-07,2,3,12,14,21745
1918,1918,2014-08-08,3,4,13,13,21758
1919,1919,2014-08-09,3,4,12,14,21772
1920,1920,2014-08-10,3,5,11,11,21783
1921,1921,2014-08-11,2,2,11,6,21789
1922,1922,2014-08-12,0,0,5,6,21795
1923,1923,2014-08-13,0,1,6,11,21806
1924,1924,2014-08-14,1,1,7,6,21812
1925,1925,2014-08-15,1,3,10,-1,21811
1926,1926,2014-08-16,52,55,56,103,21914
1927,1927,2014-08-17,2,4,12,12,21926
1928,1928,2014-08-18,3,4,10,19,21945
1929,1929,2014-08-19,0,0,4,-1,21944
1930,1930,2014-08-20,5,7,20,29,21973
1931,1931,2014-08-21,4,6,14,11,21984
1932,1932,2014-08-22,4,7,12,12,21996
1933,1933,2014-08-23,0,0,6,8,22004
1934,1934,2014-08-24,1,2,7,14,22018
1935,1935,2014-08-25,3,3,18,23,22041
1936,1936,2014-08-26,4,8,13,16,22057
1937,1937,2014-08-27,38,47,40,-59,21998
1938,1938,2014-08-28,25,25,34,60,22058
1939,1939,2014-08-29,2,2,12,17,22075
1940,1940,2014-08-30,6,7,14,-2,22073
1941,1941,2014-08-31,0,0,4,6,22079
1942,1942,2014-09-01,5,6,12,12,22091
1943,1943,2014-09-02,1,5,3,6,22097
1944,1944,2014-09-03,4,6,11,2,22099
1945,1945,2014-09-04,0,2,13,23,22122
1946,1946,2014-09-05,0,1,9,13,22135
1947,1947,2014-09-06,109,117,112,186,22321
1948,1948,2014-09-07,8,9,13,23,22344
1949,1949,2014-09-08,3,3,11,15,22359
1950,1950,2014-09-09,0,1,10,15,22374
1951,1951,2014-09-10,2,8,12,14,22388
1952,1952,2014-09-11,12,12,27,11,22399
1953,1953,2014-09-12,75,79,80,129,22528
1954,1954,2014-09-13,3,7,15,8,22536
1955,1955,2014-09-14,7,11,17,17,22553
1956,1956,2014-09-15,9,9,22,34,22587
1957,1957,2014-09-16,1,2,7,13,22600
1958,1958,2014-09-17,1,3,10,10,22610
1959,1959,2014-09-18,1,1,9,16,22626
1960,1960,2014-09-19,36,42,47,84,22710
1961,1961,2014-09-20,2,2,8,6,22716
1962,1962,2014-09-21,17,20,21,26,22742
1963,1963,2014-09-22,3,3,15,15,22757
1964,1964,2014-09-23,1,1,12,19,22776
1965,1965,2014-09-24,3,3,12,16,22792
1966,1966,2014-09-25,17,20,21,19,22811
1967,1967,2014-09-26,27,32,32,61,22872
1968,1968,2014-09-27,0,2,6,14,22886
1969,1969,2014-09-28,48,65,41,-45,22841
1970,1970,2014-09-29,0,2,7,12,22853
1971,1971,2014-09-30,10,13,15,-4,22849
1972,1972,2014-10-01,8,9,18,-3,22846
1973,1973,2014-10-02,6,10,17,19,22865
1974,1974,2014-10-03,2,2,14,20,22885
1975,1975,2014-10-04,0,0,3,4,22889
1976,1976,2014-10-05,3,3,13,14,22903
1977,1977,2014-10-06,6,9,15,14,22917
1978,1978,2014-10-07,16,20,22,-10,22907
1979,1979,2014-10-08,6,6,12,8,22915
1980,1980,2014-10-09,7,9,13,25,22940
1981,1981,2014-10-10,0,0,7,8,22948
1982,1982,2014-10-11,2,4,9,12,22960
1983,1983,2014-10-12,1,1,11,20,22980
1984,1984,2014-10-13,11,12,24,24,23004
1985,1985,2014-10-14,1,3,10,13,23017
1986,1986,2014-10-15,4,8,8,2,23019
1987,1987,2014-10-16,2,4,11,13,23032
1988,1988,2014-10-17,1,3,8,14,23046
1989,1989,2014-10-18,3,4,13,20,23066
1990,1990,2014-10-19,6,7,14,16,23082
1991,1991,2014-10-20,22,23,39,-25,23057
1992,1992,2014-10-21,4,4,17,22,23079
1993,1993,2014-10-22,0,2,9,15,23094
1994,1994,2014-10-23,3,5,20,23,23117
1995,1995,2014-10-24,1,2,8,12,23129
1996,1996,2014-10-25,3,4,6,7,23136
1997,1997,2014-10-26,2,5,13,12,23148
1998,1998,2014-10-27,1,2,7,9,23157
1999,1999,2014-10-28,3,4,7,-4,23153
2000,2000,2014-10-29,0,0,6,7,23160
2001,2001,2014-10-30,4,5,20,24,23184
2002,2002,2014-10-31,0,1,3,6,23190
2003,2003,2014-11-01,12,19,16,12,23202
2004,2004,2014-11-02,3,5,9,16,23218
2005,2005,2014-11-03,1,1,6,4,23222
2006,2006,2014-11-04,0,0,12,18,23240
2007,2007,2014-11-05,1,5,9,16,23256
2008,2008,2014-11-06,41,48,52,95,23351
2009,2009,2014-11-07,3,6,10,6,23357
2010,2010,2014-11-08,1,2,5,5,23362
2011,2011,2014-11-09,8,13,13,14,23376
2012,2012,2014-11-10,10,11,22,37,23413
2013,2013,2014-11-11,1,1,8,8,23421
2014,2014,2014-11-12,2,2,12,21,23442
2015,2015,2014-11-13,3,4,8,3,23445
2016,2016,2014-11-14,2,2,10,14,23459
2017,2017,2014-11-15,0,0,11,20,23479
2018,2018,2014-11-16,4,6,11,9,23488
2019,2019,2014-11-17,5,8,17,27,23515
2020,2020,2014-11-18,39,48,45,77,23592
2021,2021,2014-11-19,7,10,18,25,23617
2022,2022,2014-11-20,2,2,11,13,23630
2023,2023,2014-11-21,4,4,18,4,23634
2024,2024,2014-11-22,4,7,15,22,23656
2025,2025,2014-11-23,29,36,31,55,23711
2026,2026,2014-11-24,50,62,49,21,23732
2027,2027,2014-11-25,18,22,33,43,23775
2028,2028,2014-11-26,8,10,14,23,23798
2029,2029,2014-11-27,3,6,9,13,23811
2030,2030,2014-11-28,3,8,10,6,23817
2031,2031,2014-11-29,4,4,13,16,23833
2032,2032,2014-11-30,14,17,20,30,23863
2033,2033,2014-12-01,4,5,14,19,23882
2034,2034,2014-12-02,79,94,74,17,23899
2035,2035,2014-12-03,11,12,26,22,23921
2036,2036,2014-12-04,7,7,16,8,23929
2037,2037,2014-12-05,2,4,13,11,23940
2038,2038,2014-12-06,7,9,15,2,23942
2039,2039,2014-12-07,7,9,14,18,23960
2040,2040,2014-12-08,0,1,8,14,23974
2041,2041,2014-12-09,13,20,21,14,23988
2042,2042,2014-12-10,30,43,32,80,24068
2043,2043,2014-12-11,3,3,19,10,24078
2044,2044,2014-12-12,14,22,17,39,24117
2045,2045,2014-12-13,1,3,9,6,24123
2046,2046,2014-12-14,10,13,19,-5,24118
2047,2047,2014-12-15,7,14,19,12,24130
2048,2048,2014-12-16,4,5,18,21,24151
2049,2049,2014-12-17,1,1,8,14,24165
2050,2050,2014-12-18,5,7,18,22,24187
2051,2051,2014-12-19,7,9,15,15,24202
2052,2052,2014-12-20,3,4,8,11,24213
2053,2053,2014-12-21,40,47,42,73,24286
2054,2054,2014-12-22,4,5,14,19,24305
2055,2055,2014-12-23,9,14,21,26,24331
2056,2056,2014-12-24,5,6,21,12,24343
2057,2057,2014-12-25,1,4,5,7,24350
2058,2058,2014-12-26,2,3,8,15,24365
2059,2059,2014-12-27,2,5,15,15,24380
2060,2060,2014-12-28,5,7,15,11,24391
2061,2061,2014-12-29,2,3,27,33,24424
2062,2062,2014-12-30,4,4,20,29,24453
2063,2063,2014-12-31,6,8,25,42,24495
2064,2064,2015-01-01,4,8,13,19,24514
2065,2065,2015-01-02,0,3,7,12,24526
2066,2066,2015-01-03,39,48,50,-30,24496
2067,2067,2015-01-04,9,14,19,22,24518
2068,2068,2015-01-05,243,255,257,463,24981
2069,2069,2015-01-06,92,98,104,190,25171
2070,2070,2015-01-07,2,5,18,6,25177
2071,2071,2015-01-08,13,18,23,35,25212
2072,2072,2015-01-09,14,20,37,46,25258
2073,2073,2015-01-10,2,3,9,8,25266
2074,2074,2015-01-11,5,12,13,1,25267
2075,2075,2015-01-12,8,13,21,24,25291
2076,2076,2015-01-13,3,6,18,33,25324
2077,2077,2015-01-14,3,5,14,18,25342
2078,2078,2015-01-15,3,6,13,18,25360
2079,2079,2015-01-16,5,7,19,20,25380
2080,2080,2015-01-17,2,3,10,18,25398
2081,2081,2015-01-18,5,8,23,22,25420
2082,2082,2015-01-19,12,15,15,30,25450
2083,2083,2015-01-20,16,27,28,53,25503
2084,2084,2015-01-21,7,8,26,22,25525
2085,2085,2015-01-22,6,6,17,10,25535
2086,2086,2015-01-23,4,6,7,6,25541
2087,2087,2015-01-24,2,3,9,15,25556
2088,2088,2015-01-25,1,2,5,0,25556
2089,2089,2015-01-26,10,11,19,32,25588
2090,2090,2015-01-27,1,2,9,18,25606
2091,2091,2015-01-28,2,3,10,11,25617
2092,2092,2015-01-29,5,5,24,45,25662
2093,2093,2015-01-30,2,3,8,9,25671
2094,2094,2015-01-31,4,7,18,22,25693
2095,2095,2015-02-01,7,9,17,10,25703
2096,2096,2015-02-02,13,17,27,34,25737
2097,2097,2015-02-03,52,58,63,119,25856
2098,2098,2015-02-04,2,6,11,8,25864
2099,2099,2015-02-05,7,12,20,3,25867
2100,2100,2015-02-06,6,8,16,27,25894
2101,2101,2015-02-07,1,4,7,11,25905
2102,2102,2015-02-08,3,6,13,16,25921
2103,2103,2015-02-09,2,2,19,30,25951
2104,2104,2015-02-10,10,16,23,24,25975
2105,2105,2015-02-11,4,7,18,29,26004
2106,2106,2015-02-12,30,31,51,62,26066
2107,2107,2015-02-13,9,12,25,25,26091
2108,2108,2015-02-14,1,2,12,17,26108
2109,2109,2015-02-15,19,26,36,46,26154
2110,2110,2015-02-16,6,8,25,37,26191
2111,2111,2015-02-17,176,208,164,315,26506
2112,2112,2015-02-18,3,7,19,22,26528
2113,2113,2015-02-19,0,1,14,12,26540
2114,2114,2015-02-20,11,15,29,27,26567
2115,2115,2015-02-21,1,4,12,17,26584
2116,2116,2015-02-22,5,5,21,5,26589
2117,2117,2015-02-23,0,0,13,18,26607
2118,2118,2015-02-24,20,47,17,5,26612
2119,2119,2015-02-25,2,4,22,37,26649
2120,2120,2015-02-26,11,14,34,34,26683
2121,2121,2015-02-27,0,1,14,24,26707
2122,2122,2015-02-28,3,6,23,34,26741
2123,2123,2015-03-01,6,10,27,43,26784
2124,2124,2015-03-02,2,3,22,25,26809
2125,2125,2015-03-03,11,13,30,52,26861
2126,2126,2015-03-04,3,5,17,25,26886
2127,2127,2015-03-05,5,5,16,29,26915
2128,2128,2015-03-06,1,3,12,15,26930
2129,2129,2015-03-07,2,3,12,18,26948
2130,2130,2015-03-08,65,67,76,150,27098
2131,2131,2015-03-09,8,12,26,34,27132
2132,2132,2015-03-10,2,2,14,20,27152
2133,2133,2015-03-11,1,2,13,16,27168
2134,2134,2015-03-12,9,11,22,41,27209
2135,2135,2015-03-13,5,9,20,35,27244
2136,2136,2015-03-14,3,4,18,21,27265
2137,2137,2015-03-15,4,7,16,22,27287
2138,2138,2015-03-16,5,7,15,6,27293
2139,2139,2015-03-17,3,3,18,24,27317
2140,2140,2015-03-18,25,27,39,50,27367
2141,2141,2015-03-19,2,5,11,11,27378
2142,2142,2015-03-20,4,6,20,35,27413
2143,2143,2015-03-21,1,1,11,16,27429
2144,2144,2015-03-22,5,6,18,12,27441
2145,2145,2015-03-23,4,5,21,9,27450
2146,2146,2015-03-24,2,6,11,26,27476
2147,2147,2015-03-25,4,6,13,17,27493
2148,2148,2015-03-26,10,11,24,35,27528
2149,2149,2015-03-27,13,14,31,50,27578
2150,2150,2015-03-28,14,16,24,38,27616
2151,2151,2015-03-29,5,8,18,11,27627
2152,2152,2015-03-30,11,13,27,51,27678
2153,2153,2015-03-31,5,6,12,11,27689
2154,2154,2015-04-01,2,2,8,9,27698
2155,2155,2015-04-02,4,7,15,17,27715
2156,2156,2015-04-03,5,8,17,18,27733
2157,2157,2015-04-04,1,2,11,20,27753
2158,2158,2015-04-05,5,5,8,2,27755
2159,2159,2015-04-06,6,10,14,22,27777
2160,2160,2015-04-07,5,6,16,9,27786
2161,2161,2015-04-08,1,3,10,18,27804
2162,2162,2015-04-09,5,7,16,15,27819
2163,2163,2015-04-10,3,5,13,22,27841
2164,2164,2015-04-11,4,5,15,12,27853
2165,2165,2015-04-12,2,4,16,26,27879
2166,2166,2015-04-13,1,3,8,9,27888
2167,2167,2015-04-14,7,9,15,22,27910
2168,2168,2015-04-15,5,5,11,19,27929
2169,2169,2015-04-16,32,33,37,71,28000
2170,2170,2015-04-17,1,1,8,14,28014
2171,2171,2015-04-18,0,1,9,17,28031
2172,2172,2015-04-19,14,17,22,24,28055
2173,2173,2015-04-20,1,3,10,20,28075
2174,2174,2015-04-21,3,4,17,19,28094
2175,2175,2015-04-22,1,2,9,11,28105
2176,2176,2015-04-23,2,4,15,12,28117
2177,2177,2015-04-24,9,10,24,7,28124
2178,2178,2015-04-25,1,4,11,6,28130
2179,2179,2015-04-26,1,1,6,8,28138
2180,2180,2015-04-27,3,3,17,21,28159
2181,2181,2015-04-28,12,15,18,19,28178
2182,2182,2015-04-29,146,152,157,308,28486
2183,2183,2015-04-30,3,4,16,25,28511
2184,2184,2015-05-01,4,7,10,-1,28510
2185,2185,2015-05-02,1,1,10,11,28521
2186,2186,2015-05-03,1,4,6,8,28529
2187,2187,2015-05-04,1,1,9,7,28536
2188,2188,2015-05-05,2,2,13,12,28548
2189,2189,2015-05-06,3,3,19,10,28558
2190,2190,2015-05-07,5,5,14,28,28586
2191,2191,2015-05-08,2,3,9,9,28595
2192,2192,2015-05-09,4,4,15,28,28623
2193,2193,2015-05-10,5,6,22,32,28655
2194,2194,2015-05-11,28,29,37,60,28715
2195,2195,2015-05-12,6,8,14,9,28724
2196,2196,2015-05-13,2,2,9,13,28737
2197,2197,2015-05-14,1,1,14,22,28759
2198,2198,2015-05-15,0,0,14,20,28779
2199,2199,2015-05-16,2,2,7,2,28781
2200,2200,2015-05-17,0,0,9,12,28793
2201,2201,2015-05-18,7,10,17,10,28803
2202,2202,2015-05-19,14,15,25,48,28851
2203,2203,2015-05-20,2,6,11,18,28869
2204,2204,2015-05-21,2,3,8,10,28879
2205,2205,2015-05-22,4,4,20,30,28909
2206,2206,2015-05-23,1,3,6,9,28918
2207,2207,2015-05-24,8,8,19,23,28941
2208,2208,2015-05-25,86,90,96,177,29118
2209,2209,2015-05-26,2,6,10,7,29125
2210,2210,2015-05-27,46,50,55,89,29214
2211,2211,2015-05-28,0,0,5,6,29220
2212,2212,2015-05-29,0,0,4,8,29228
2213,2213,2015-05-30,3,3,15,15,29243
2214,2214,2015-05-31,6,9,10,3,29246
2215,2215,2015-06-01,1,2,5,2,29248
2216,2216,2015-06-02,7,9,12,16,29264
2217,2217,2015-06-03,1,1,13,18,29282
2218,2218,2015-06-04,8,9,25,33,29315
2219,2219,2015-06-05,5,6,13,14,29329
2220,2220,2015-06-06,9,9,24,1,29330
2221,2221,2015-06-07,46,56,46,-28,29302
2222,2222,2015-06-08,11,13,24,2,29304
2223,2223,2015-06-09,1,1,19,27,29331
2224,2224,2015-06-10,10,12,20,31,29362
2225,2225,2015-06-11,0,2,11,18,29380
2226,2226,2015-06-12,2,3,13,10,29390
2227,2227,2015-06-13,6,8,16,17,29407
2228,2228,2015-06-14,0,1,11,22,29429
2229,2229,2015-06-15,2,2,17,26,29455
2230,2230,2015-06-16,3,3,18,23,29478
2231,2231,2015-06-17,5,7,14,10,29488
2232,2232,2015-06-18,14,15,25,-7,29481
2233,2233,2015-06-19,3,4,18,22,29503
2234,2234,2015-06-20,3,3,12,11,29514
2235,2235,2015-06-21,1,2,12,14,29528
2236,2236,2015-06-22,1,1,11,16,29544
2237,2237,2015-06-23,3,6,9,15,29559
2238,2238,2015-06-24,163,262,76,-115,29444
2239,2239,2015-06-25,2,3,10,12,29456
2240,2240,2015-06-26,0,1,4,2,29458
2241,2241,2015-06-27,54,59,54,99,29557
2242,2242,2015-06-28,0,1,5,10,29567
2243,2243,2015-06-29,9,11,21,25,29592
2244,2244,2015-06-30,0,0,7,12,29604
2245,2245,2015-07-01,2,2,9,17,29621
2246,2246,2015-07-02,6,8,17,7,29628
2247,2247,2015-07-03,0,0,10,13,29641
2248,2248,2015-07-04,3,3,13,18,29659
2249,2249,2015-07-05,2,2,10,16,29675
2250,2250,2015-07-06,4,5,14,14,29689
2251,2251,2015-07-07,3,7,10,10,29699
2252,2252,2015-07-08,21,21,31,-8,29691
2253,2253,2015-07-09,0,0,14,22,29713
2254,2254,2015-07-10,2,2,14,21,29734
2255,2255,2015-07-11,3,6,8,2,29736
2256,2256,2015-07-12,12,15,20,9,29745
2257,2257,2015-07-13,5,7,18,26,29771
2258,2258,2015-07-14,10,14,19,7,29778
2259,2259,2015-07-15,5,7,15,14,29792
2260,2260,2015-07-16,27,32,38,25,29817
2261,2261,2015-07-17,4,4,13,11,29828
2262,2262,2015-07-18,5,27,-6,41,29869
2263,2263,2015-07-19,7,7,20,15,29884
2264,2264,2015-07-20,5,7,15,3,29887
2265,2265,2015-07-21,4,5,16,22,29909
2266,2266,2015-07-22,3,5,17,29,29938
2267,2267,2015-07-23,11,12,24,39,29977
2268,2268,2015-07-24,1,1,9,9,29986
2269,2269,2015-07-25,28,37,39,45,30031
2270,2270,2015-07-26,10,14,13,10,30041
2271,2271,2015-07-27,1,2,18,24,30065
2272,2272,2015-07-28,18,21,36,48,30113
2273,2273,2015-07-29,4,5,9,17,30130
2274,2274,2015-07-30,5,7,12,18,30148
2275,2275,2015-07-31,3,4,9,17,30165
2276,2276,2015-08-01,3,7,10,19,30184
2277,2277,2015-08-02,2,2,10,8,30192
2278,2278,2015-08-03,5,6,16,20,30212
2279,2279,2015-08-04,21,45,9,4,30216
2280,2280,2015-08-05,2,3,12,14,30230
2281,2281,2015-08-06,39,49,43,-52,30178
2282,2282,2015-08-07,5,8,22,23,30201
2283,2283,2015-08-08,2,4,10,1,30202
2284,2284,2015-08-09,5,5,17,19,30221
2285,2285,2015-08-10,1,3,14,25,30246
2286,2286,2015-08-11,7,9,28,31,30277
2287,2287,2015-08-12,10,32,0,31,30308
2288,2288,2015-08-13,12,18,18,22,30330
2289,2289,2015-08-14,7,7,17,10,30340
2290,2290,2015-08-15,28,37,32,52,30392
2291,2291,2015-08-16,6,10,10,-3,30389
2292,2292,2015-08-17,10,14,24,12,30401
2293,2293,2015-08-18,3,6,18,9,30410
2294,2294,2015-08-19,4,7,14,24,30434
2295,2295,2015-08-20,2,5,12,18,30452
2296,2296,2015-08-21,2,4,12,7,30459
2297,2297,2015-08-22,4,5,17,13,30472
2298,2298,2015-08-23,1,3,9,9,30481
2299,2299,2015-08-24,17,21,23,31,30512
2300,2300,2015-08-25,1,1,9,8,30520
2301,2301,2015-08-26,1,1,14,4,30524
2302,2302,2015-08-27,39,41,47,16,30540
2303,2303,2015-08-28,0,0,8,13,30553
2304,2304,2015-08-29,0,0,10,13,30566
2305,2305,2015-08-30,4,6,10,11,30577
2306,2306,2015-08-31,1,3,9,8,30585
