,Unnamed: 0,review_date,helpful_votes,total_votes,weighted_votes,weighted_ratings,culmulative_weighted_rating
0,0,2003-04-27,0,0,1,-1,-1
1,1,2003-12-02,2,2,3,-6,-7
2,2,2004-04-04,1,1,3,4,-3
3,3,2004-05-24,0,0,1,-1,-4
4,4,2004-06-20,2,3,2,-2,-6
5,5,2005-02-06,0,0,1,2,-4
6,6,2005-04-07,276,308,292,197,193
7,7,2005-04-08,42,60,32,84,277
8,8,2005-10-02,6,6,7,14,291
9,9,2005-11-21,6,6,7,14,305
10,10,2006-02-20,4,4,5,5,310
11,11,2006-03-15,19,20,19,38,348
12,12,2006-04-01,6,6,7,14,362
13,13,2006-08-27,6,7,6,12,374
14,14,2006-10-02,24,26,23,46,420
15,15,2006-10-18,5,5,6,12,432
16,16,2006-11-01,9,12,7,14,446
17,17,2006-11-18,4,11,-2,4,450
18,18,2006-12-03,4,5,4,4,454
19,19,2006-12-11,1,1,2,4,458
20,20,2007-01-03,2,5,0,0,458
21,21,2007-01-09,2,2,3,6,464
22,22,2007-01-11,8,11,7,-7,457
23,23,2007-01-31,7,7,8,8,465
24,24,2007-02-05,3,5,2,2,467
25,25,2007-03-14,3,3,4,-4,463
26,26,2007-03-18,1,2,1,-2,461
27,27,2007-04-09,2,3,2,2,463
28,28,2007-05-24,3,4,3,3,466
29,29,2007-06-12,3,12,-5,10,476
30,30,2007-06-27,0,0,1,1,477
31,31,2007-07-07,1,1,2,4,481
32,32,2007-07-10,1,1,2,2,483
33,33,2007-07-13,4,7,2,4,487
34,34,2007-07-19,0,0,1,0,487
35,35,2007-07-28,7,11,4,4,491
36,36,2007-08-09,2,3,2,4,495
37,37,2007-08-11,2,3,2,4,499
38,38,2007-08-16,16,18,15,15,514
39,39,2007-08-27,2,2,3,-3,511
40,40,2007-09-06,0,12,-11,0,511
41,41,2007-09-10,2,3,2,-2,509
42,42,2007-09-14,7,7,8,8,517
43,43,2007-09-15,0,0,1,2,519
44,44,2007-09-19,2,4,1,2,521
45,45,2007-09-29,3,4,3,-3,518
46,46,2007-09-30,1,1,2,2,520
47,47,2007-10-17,19,20,19,38,558
48,48,2007-10-30,3,3,4,8,566
49,49,2007-11-07,0,0,1,2,568
50,50,2007-11-26,0,0,1,2,570
51,51,2007-12-02,4,5,4,8,578
52,52,2007-12-06,3,6,2,4,582
53,53,2007-12-16,8,10,7,14,596
54,54,2007-12-18,0,0,1,2,598
55,55,2007-12-31,4,4,5,10,608
56,56,2008-01-02,0,0,1,2,610
57,57,2008-01-05,0,0,1,2,612
58,58,2008-01-18,21,38,5,-5,607
59,59,2008-02-10,8,10,7,0,607
60,60,2008-02-11,0,0,1,2,609
61,61,2008-02-14,7,10,5,5,614
62,62,2008-02-15,1,2,1,2,616
63,63,2008-03-16,31,33,30,-30,586
64,64,2008-03-18,4,5,4,4,590
65,65,2008-03-28,0,6,-5,0,590
66,66,2008-03-29,4,5,4,8,598
67,67,2008-04-06,0,0,1,2,600
68,68,2008-04-07,1,2,1,2,602
69,69,2008-04-18,0,0,1,0,602
70,70,2008-05-09,2,3,2,-4,598
71,71,2008-05-15,3,3,4,0,598
72,72,2008-05-24,0,4,-3,-3,595
73,73,2008-06-02,0,0,1,2,597
74,74,2008-06-04,1,2,2,4,601
75,75,2008-06-05,0,0,1,2,603
76,76,2008-06-13,0,0,1,0,603
77,77,2008-06-17,0,0,1,2,605
78,78,2008-06-18,0,0,1,2,607
79,79,2008-06-21,0,2,-1,2,609
80,80,2008-06-23,1,1,2,4,613
81,81,2008-06-26,0,0,1,1,614
82,82,2008-07-07,0,0,1,2,616
83,83,2008-07-25,9,22,-1,6,622
84,84,2008-08-08,1,1,2,2,624
85,85,2008-08-09,0,0,1,1,625
86,86,2008-08-13,1,1,3,6,631
87,87,2008-08-17,12,13,12,-12,619
88,88,2008-08-21,3,4,3,6,625
89,89,2008-08-22,0,0,1,2,627
90,90,2008-08-25,1,1,2,4,631
91,91,2008-09-04,0,0,2,4,635
92,92,2008-09-08,0,0,1,2,637
93,93,2008-09-16,0,2,-1,-2,635
94,94,2008-09-22,4,5,5,10,645
95,95,2008-09-30,30,36,27,54,699
96,96,2008-10-05,0,1,0,0,699
97,97,2008-10-08,12,13,12,0,699
98,98,2008-10-21,0,0,1,2,701
99,99,2008-10-24,1,1,2,2,703
100,100,2008-10-30,5,6,5,10,713
101,101,2008-11-02,3,3,4,8,721
102,102,2008-11-09,6,6,7,14,735
103,103,2008-11-11,1,1,2,4,739
104,104,2008-11-12,0,0,2,4,743
105,105,2008-11-27,0,0,1,2,745
106,106,2008-11-30,0,0,1,2,747
107,107,2008-12-01,7,7,8,16,763
108,108,2008-12-06,0,0,1,2,765
109,109,2008-12-15,0,0,1,2,767
110,110,2008-12-22,1,1,2,-2,765
111,111,2008-12-23,6,7,6,0,765
112,112,2008-12-25,3,3,5,10,775
113,113,2008-12-28,1,1,2,4,779
114,114,2008-12-29,4,7,3,3,782
115,115,2009-01-01,0,0,1,2,784
116,116,2009-01-06,0,0,1,2,786
117,117,2009-01-12,0,0,1,2,788
118,118,2009-01-20,0,0,1,2,790
119,119,2009-02-02,0,0,1,2,792
120,120,2009-02-09,0,0,2,4,796
121,121,2009-02-12,33,35,32,64,860
122,122,2009-02-15,0,0,2,4,864
123,123,2009-02-16,2,4,2,-2,862
124,124,2009-02-17,0,0,1,0,862
125,125,2009-02-23,0,0,1,2,864
126,126,2009-02-24,0,0,1,2,866
127,127,2009-03-06,2,5,0,0,866
128,128,2009-03-07,1,1,2,2,868
129,129,2009-03-09,3,3,6,11,879
130,130,2009-03-12,7,10,5,10,889
131,131,2009-03-14,0,0,1,2,891
132,132,2009-03-22,1,5,-1,4,895
133,133,2009-03-24,1,1,2,2,897
134,134,2009-03-28,1,2,1,-1,896
135,135,2009-03-31,0,0,1,2,898
136,136,2009-04-01,1,2,1,1,899
137,137,2009-04-04,0,0,1,2,901
138,138,2009-04-05,2,2,3,6,907
139,139,2009-04-10,6,6,8,16,923
140,140,2009-04-12,0,0,1,2,925
141,141,2009-04-14,0,0,2,4,929
142,142,2009-04-15,0,1,0,0,929
143,143,2009-04-16,0,0,1,2,931
144,144,2009-04-20,11,15,9,10,941
145,145,2009-04-29,2,4,1,2,943
146,146,2009-05-07,7,8,7,14,957
147,147,2009-05-08,0,1,0,0,957
148,148,2009-05-20,0,4,-3,3,960
149,149,2009-06-17,0,0,1,2,962
150,150,2009-06-26,0,0,1,1,963
151,151,2009-06-29,2,2,3,6,969
152,152,2009-07-02,1,1,2,4,973
153,153,2009-07-04,1,3,0,0,973
154,154,2009-07-07,0,1,0,0,973
155,155,2009-07-11,0,0,1,1,974
156,156,2009-07-16,0,5,-4,4,978
157,157,2009-07-20,3,4,3,6,984
158,158,2009-07-23,0,0,1,2,986
159,159,2009-08-02,7,7,8,16,1002
160,160,2009-08-06,1,2,1,1,1003
161,161,2009-08-10,7,9,7,0,1003
162,162,2009-08-16,0,0,1,2,1005
163,163,2009-08-30,1,2,1,2,1007
164,164,2009-09-01,0,3,-1,-2,1005
165,165,2009-09-03,0,0,1,2,1007
166,166,2009-09-07,7,12,3,-6,1001
167,167,2009-09-09,0,0,1,2,1003
168,168,2009-09-11,1,2,1,1,1004
169,169,2009-09-12,0,0,1,2,1006
170,170,2009-09-13,0,0,1,2,1008
171,171,2009-09-18,17,24,13,24,1032
172,172,2009-09-21,0,0,1,2,1034
173,173,2009-09-29,2,3,2,2,1036
174,174,2009-10-07,10,15,7,23,1059
175,175,2009-10-09,3,5,2,-2,1057
176,176,2009-10-12,2,2,3,0,1057
177,177,2009-10-18,2,4,2,4,1061
178,178,2009-11-01,1,2,1,-2,1059
179,179,2009-11-04,0,0,1,0,1059
180,180,2009-11-06,0,0,1,2,1061
181,181,2009-11-08,0,0,1,2,1063
182,182,2009-11-11,2,2,3,6,1069
183,183,2009-11-12,1,2,1,2,1071
184,184,2009-11-19,5,9,2,0,1071
185,185,2009-11-27,0,0,1,2,1073
186,186,2009-11-28,2,3,2,4,1077
187,187,2009-12-03,1,1,2,4,1081
188,188,2009-12-05,0,0,1,1,1082
189,189,2009-12-09,0,0,3,5,1087
190,190,2009-12-10,1,1,2,4,1091
191,191,2009-12-18,3,10,-3,6,1097
192,192,2009-12-22,12,17,8,16,1113
193,193,2009-12-23,2,4,1,2,1115
194,194,2009-12-26,0,0,1,2,1117
195,195,2009-12-28,0,0,1,2,1119
196,196,2009-12-29,0,0,1,2,1121
197,197,2009-12-30,1,1,2,2,1123
198,198,2010-01-02,0,1,0,0,1123
199,199,2010-01-13,3,3,4,8,1131
200,200,2010-01-14,4,4,6,12,1143
201,201,2010-01-17,0,0,1,2,1145
202,202,2010-01-20,0,0,1,0,1145
203,203,2010-01-23,1,1,2,4,1149
204,204,2010-01-25,0,0,2,4,1153
205,205,2010-01-27,0,1,0,0,1153
206,206,2010-01-29,1,2,2,4,1157
207,207,2010-01-31,4,5,5,6,1163
208,208,2010-02-11,36,43,30,-30,1133
209,209,2010-02-15,4,7,2,4,1137
210,210,2010-02-16,1,2,1,-1,1136
211,211,2010-02-20,1,1,2,4,1140
212,212,2010-02-21,5,7,4,-4,1136
213,213,2010-02-26,2,2,3,6,1142
214,214,2010-02-28,0,0,1,2,1144
215,215,2010-03-02,1,1,2,2,1146
216,216,2010-03-04,0,0,1,2,1148
217,217,2010-03-08,2,2,3,6,1154
218,218,2010-03-09,3,3,4,8,1162
219,219,2010-03-13,3,7,1,2,1164
220,220,2010-03-15,2,2,3,3,1167
221,221,2010-03-19,8,8,10,19,1186
222,222,2010-03-21,2,3,3,6,1192
223,223,2010-03-23,0,0,1,2,1194
224,224,2010-04-06,2,2,3,-3,1191
225,225,2010-04-11,1,1,2,4,1195
226,226,2010-04-14,10,12,9,9,1204
227,227,2010-04-15,1,3,1,-1,1203
228,228,2010-04-25,1,1,3,6,1209
229,229,2010-04-27,0,0,2,4,1213
230,230,2010-04-28,0,6,-5,5,1218
231,231,2010-05-03,5,8,3,6,1224
232,232,2010-05-04,1,5,-2,4,1228
233,233,2010-05-05,0,0,1,2,1230
234,234,2010-05-07,2,4,1,2,1232
235,235,2010-05-08,1,2,1,1,1233
236,236,2010-05-10,1,5,0,5,1238
237,237,2010-05-11,0,0,2,3,1241
238,238,2010-05-12,11,12,13,13,1254
239,239,2010-05-13,1,1,2,4,1258
240,240,2010-05-18,0,0,1,1,1259
241,241,2010-05-20,9,13,7,14,1273
242,242,2010-05-21,0,0,1,1,1274
243,243,2010-05-25,3,7,0,0,1274
244,244,2010-05-26,4,5,5,6,1280
245,245,2010-05-30,3,15,-8,16,1296
246,246,2010-05-31,0,0,2,4,1300
247,247,2010-06-04,1,1,2,-4,1296
248,248,2010-06-05,2,4,1,-1,1295
249,249,2010-06-07,4,10,1,2,1297
250,250,2010-06-08,28,35,25,48,1345
251,251,2010-06-09,0,0,2,4,1349
252,252,2010-06-10,3,8,0,6,1355
253,253,2010-06-14,0,0,1,2,1357
254,254,2010-06-16,1,2,1,2,1359
255,255,2010-06-21,2,2,5,-2,1357
256,256,2010-06-22,0,0,1,2,1359
257,257,2010-06-25,1,2,1,2,1361
258,258,2010-06-28,2,4,2,2,1363
259,259,2010-06-30,1,2,1,2,1365
260,260,2010-07-01,0,0,1,2,1367
261,261,2010-07-03,0,0,1,2,1369
262,262,2010-07-04,2,3,3,3,1372
263,263,2010-07-07,0,1,0,0,1372
264,264,2010-07-12,0,0,1,2,1374
265,265,2010-07-15,0,0,2,4,1378
266,266,2010-07-16,0,0,1,2,1380
267,267,2010-07-17,0,1,0,0,1380
268,268,2010-07-18,0,0,1,2,1382
269,269,2010-07-19,3,4,4,7,1389
270,270,2010-07-20,1,2,2,4,1393
271,271,2010-07-21,18,19,19,35,1428
272,272,2010-07-25,0,0,1,2,1430
273,273,2010-07-26,0,1,0,0,1430
274,274,2010-07-28,1,3,1,4,1434
275,275,2010-07-31,0,0,2,4,1438
276,276,2010-08-01,0,0,1,2,1440
277,277,2010-08-02,1,1,3,5,1445
278,278,2010-08-03,2,3,3,6,1451
279,279,2010-08-05,0,0,1,2,1453
280,280,2010-08-06,3,5,3,3,1456
281,281,2010-08-08,18,19,18,36,1492
282,282,2010-08-12,2,2,3,6,1498
283,283,2010-08-13,2,2,4,2,1500
284,284,2010-08-17,0,0,1,-1,1499
285,285,2010-08-18,0,0,1,2,1501
286,286,2010-08-19,0,0,1,2,1503
287,287,2010-08-20,0,0,2,4,1507
288,288,2010-08-21,6,10,3,-6,1501
289,289,2010-08-22,0,0,1,2,1503
290,290,2010-08-25,5,5,7,14,1517
291,291,2010-08-29,20,20,22,23,1540
292,292,2010-08-31,17,17,18,36,1576
293,293,2010-09-03,4,4,5,10,1586
294,294,2010-09-05,0,0,1,2,1588
295,295,2010-09-06,0,0,3,4,1592
296,296,2010-09-07,2,2,3,-3,1589
297,297,2010-09-09,1,2,1,-2,1587
298,298,2010-09-10,2,3,3,6,1593
299,299,2010-09-12,0,0,1,2,1595
300,300,2010-09-13,0,0,1,1,1596
301,301,2010-09-14,3,4,4,2,1598
302,302,2010-09-17,0,0,1,2,1600
303,303,2010-09-18,0,0,1,2,1602
304,304,2010-09-19,1,1,2,4,1606
305,305,2010-09-20,0,0,1,2,1608
306,306,2010-09-25,0,0,1,2,1610
307,307,2010-09-26,10,10,12,-20,1590
308,308,2010-09-28,8,12,6,1,1591
309,309,2010-10-01,3,5,2,0,1591
310,310,2010-10-04,2,2,5,10,1601
311,311,2010-10-05,2,5,4,5,1606
312,312,2010-10-07,17,19,17,-30,1576
313,313,2010-10-08,66,81,52,52,1628
314,314,2010-10-11,0,0,1,1,1629
315,315,2010-10-12,0,0,2,3,1632
316,316,2010-10-15,88,101,77,3,1635
317,317,2010-10-16,2,3,3,0,1635
318,318,2010-10-18,1,2,3,3,1638
319,319,2010-10-19,51,70,33,33,1671
320,320,2010-10-22,1,1,3,6,1677
321,321,2010-10-27,2,2,4,4,1681
322,322,2010-10-28,2,4,2,4,1685
323,323,2010-10-29,0,0,1,2,1687
324,324,2010-11-01,0,0,2,3,1690
325,325,2010-11-03,2,2,6,7,1697
326,326,2010-11-04,3,12,-3,14,1711
327,327,2010-11-05,0,0,1,2,1713
328,328,2010-11-07,0,0,2,4,1717
329,329,2010-11-08,0,0,1,1,1718
330,330,2010-11-09,0,0,1,2,1720
331,331,2010-11-10,0,0,1,2,1722
332,332,2010-11-11,0,0,1,2,1724
333,333,2010-11-12,0,0,1,2,1726
334,334,2010-11-16,1,1,2,4,1730
335,335,2010-11-18,4,6,3,6,1736
336,336,2010-11-20,0,0,1,2,1738
337,337,2010-11-23,3,4,4,8,1746
338,338,2010-11-24,3,5,2,0,1746
339,339,2010-11-25,0,0,1,1,1747
340,340,2010-11-29,0,0,1,2,1749
341,341,2010-11-30,1,5,0,6,1755
342,342,2010-12-01,0,0,1,2,1757
343,343,2010-12-02,1,3,1,2,1759
344,344,2010-12-03,0,0,1,2,1761
345,345,2010-12-04,0,1,1,2,1763
346,346,2010-12-07,0,0,2,4,1767
347,347,2010-12-12,2,3,2,2,1769
348,348,2010-12-13,0,1,2,4,1773
349,349,2010-12-14,0,0,2,4,1777
350,350,2010-12-15,0,0,2,4,1781
351,351,2010-12-17,0,0,2,3,1784
352,352,2010-12-18,5,7,4,8,1792
353,353,2010-12-19,0,1,0,0,1792
354,354,2010-12-20,3,9,0,6,1798
355,355,2010-12-22,0,0,1,1,1799
356,356,2010-12-24,1,1,2,4,1803
357,357,2010-12-27,0,0,1,2,1805
358,358,2010-12-28,5,6,6,12,1817
359,359,2010-12-29,1,2,1,1,1818
360,360,2010-12-30,0,0,1,2,1820
361,361,2010-12-31,1,1,2,4,1824
362,362,2011-01-01,0,0,1,2,1826
363,363,2011-01-02,0,0,1,1,1827
364,364,2011-01-03,3,3,6,4,1831
365,365,2011-01-05,0,3,-1,6,1837
366,366,2011-01-07,3,3,7,14,1851
367,367,2011-01-11,0,3,-2,4,1855
368,368,2011-01-12,3,4,3,6,1861
369,369,2011-01-13,32,38,28,-52,1809
370,370,2011-01-14,1,2,1,2,1811
371,371,2011-01-16,0,0,1,1,1812
372,372,2011-01-17,0,0,1,2,1814
373,373,2011-01-18,0,0,3,4,1818
374,374,2011-01-19,1,1,2,4,1822
375,375,2011-01-20,6,9,5,9,1831
376,376,2011-01-23,2,4,1,-2,1829
377,377,2011-02-01,7,7,8,16,1845
378,378,2011-02-02,1,1,2,4,1849
379,379,2011-02-03,0,0,1,1,1850
380,380,2011-02-04,2,2,3,6,1856
381,381,2011-02-05,1,1,4,8,1864
382,382,2011-02-06,1,2,2,3,1867
383,383,2011-02-07,13,18,14,24,1891
384,384,2011-02-08,0,3,-1,0,1891
385,385,2011-02-09,33,35,36,71,1962
386,386,2011-02-10,0,2,-1,2,1964
387,387,2011-02-11,4,7,3,6,1970
388,388,2011-02-12,0,0,1,0,1970
389,389,2011-02-13,3,4,4,7,1977
390,390,2011-02-14,0,0,1,-1,1976
391,391,2011-02-15,0,8,-3,20,1996
392,392,2011-02-17,1,1,3,6,2002
393,393,2011-02-18,0,0,2,4,2006
394,394,2011-02-21,1,1,3,6,2012
395,395,2011-02-22,0,0,2,4,2016
396,396,2011-02-25,1,2,1,2,2018
397,397,2011-02-27,12,14,15,19,2037
398,398,2011-02-28,5,7,6,12,2049
399,399,2011-03-01,6,9,7,9,2058
400,400,2011-03-02,0,0,5,5,2063
401,401,2011-03-03,6,11,3,6,2069
402,402,2011-03-04,0,0,1,2,2071
403,403,2011-03-08,0,0,2,3,2074
404,404,2011-03-09,4,5,6,8,2082
405,405,2011-03-10,0,3,-2,4,2086
406,406,2011-03-11,181,206,159,170,2256
407,407,2011-03-12,18,23,16,-24,2232
408,408,2011-03-13,1,7,-1,7,2239
409,409,2011-03-15,3,4,4,8,2247
410,410,2011-03-16,0,0,2,4,2251
411,411,2011-03-17,0,0,1,0,2251
412,412,2011-03-18,5,5,6,12,2263
413,413,2011-03-21,1,1,4,6,2269
414,414,2011-03-22,0,0,3,5,2274
415,415,2011-03-23,0,0,2,4,2278
416,416,2011-03-24,0,0,1,2,2280
417,417,2011-03-25,1,1,3,3,2283
418,418,2011-03-27,1,1,2,4,2287
419,419,2011-03-28,1,2,1,1,2288
420,420,2011-03-29,1,4,2,6,2294
421,421,2011-03-30,0,1,0,0,2294
422,422,2011-03-31,68,94,48,57,2351
423,423,2011-04-01,0,1,1,2,2353
424,424,2011-04-04,3,4,4,7,2360
425,425,2011-04-05,1,2,3,6,2366
426,426,2011-04-06,1,1,2,0,2366
427,427,2011-04-08,8,9,8,16,2382
428,428,2011-04-09,1,2,4,4,2386
429,429,2011-04-11,0,0,2,4,2390
430,430,2011-04-12,2,9,-3,10,2400
431,431,2011-04-13,0,0,1,1,2401
432,432,2011-04-15,0,0,3,5,2406
433,433,2011-04-16,0,0,1,2,2408
434,434,2011-04-17,1,1,2,4,2412
435,435,2011-04-18,0,0,2,4,2416
436,436,2011-04-20,0,0,1,1,2417
437,437,2011-04-23,0,0,1,1,2418
438,438,2011-04-24,0,0,1,1,2419
439,439,2011-04-25,0,1,1,2,2421
440,440,2011-04-27,0,1,0,0,2421
441,441,2011-04-28,6,8,7,12,2433
442,442,2011-04-30,0,0,2,4,2437
443,443,2011-05-02,0,0,1,1,2438
444,444,2011-05-03,1,1,7,14,2452
445,445,2011-05-04,1,2,2,4,2456
446,446,2011-05-05,1,2,4,6,2462
447,447,2011-05-06,0,0,1,2,2464
448,448,2011-05-07,0,0,1,2,2466
449,449,2011-05-09,22,27,19,21,2487
450,450,2011-05-10,20,25,16,-16,2471
451,451,2011-05-11,4,5,5,8,2479
452,452,2011-05-12,0,0,1,0,2479
453,453,2011-05-13,0,0,1,2,2481
454,454,2011-05-15,6,13,1,-2,2479
455,455,2011-05-16,0,0,2,3,2482
456,456,2011-05-17,5,8,5,-3,2479
457,457,2011-05-18,0,0,1,2,2481
458,458,2011-05-19,0,1,3,3,2484
459,459,2011-05-20,2,2,5,5,2489
460,460,2011-05-21,0,0,2,1,2490
461,461,2011-05-23,10,12,14,-7,2483
462,462,2011-05-24,0,0,1,1,2484
463,463,2011-05-25,1,1,4,2,2486
464,464,2011-05-26,2,3,5,1,2487
465,465,2011-05-27,0,0,1,1,2488
466,466,2011-05-28,0,0,1,2,2490
467,467,2011-06-02,3,5,3,0,2490
468,468,2011-06-03,3,5,3,6,2496
469,469,2011-06-05,5,6,6,12,2508
470,470,2011-06-06,0,0,1,2,2510
471,471,2011-06-07,1,2,3,4,2514
472,472,2011-06-08,0,0,1,0,2514
473,473,2011-06-10,2,3,2,-4,2510
474,474,2011-06-11,0,0,1,2,2512
475,475,2011-06-15,0,0,1,1,2513
476,476,2011-06-16,3,6,3,-1,2512
477,477,2011-06-17,9,13,7,-2,2510
478,478,2011-06-18,9,11,10,20,2530
479,479,2011-06-19,1,1,2,4,2534
480,480,2011-06-20,6,8,6,0,2534
481,481,2011-06-21,1,2,2,2,2536
482,482,2011-06-23,1,2,1,1,2537
483,483,2011-06-24,0,0,1,1,2538
484,484,2011-06-26,0,1,1,2,2540
485,485,2011-06-27,6,8,13,17,2557
486,486,2011-06-28,0,0,1,1,2558
487,487,2011-06-30,4,6,5,7,2565
488,488,2011-07-01,0,0,1,2,2567
489,489,2011-07-02,0,0,1,-1,2566
490,490,2011-07-03,0,0,1,2,2568
491,491,2011-07-04,3,4,4,8,2576
492,492,2011-07-07,0,0,3,3,2579
493,493,2011-07-08,6,7,9,17,2596
494,494,2011-07-11,0,0,2,3,2599
495,495,2011-07-13,0,0,1,2,2601
496,496,2011-07-16,3,7,2,7,2608
497,497,2011-07-17,0,1,0,0,2608
498,498,2011-07-18,0,0,1,2,2610
499,499,2011-07-19,1,2,1,2,2612
500,500,2011-07-20,1,1,2,4,2616
501,501,2011-07-22,2,2,3,6,2622
502,502,2011-07-24,0,0,2,4,2626
503,503,2011-07-25,0,0,2,4,2630
504,504,2011-07-26,0,0,1,2,2632
505,505,2011-07-27,0,0,1,2,2634
506,506,2011-07-30,4,8,1,-2,2632
507,507,2011-08-01,3,3,6,8,2640
508,508,2011-08-02,0,0,1,2,2642
509,509,2011-08-03,2,3,3,6,2648
510,510,2011-08-04,0,0,1,2,2650
511,511,2011-08-05,0,0,1,2,2652
512,512,2011-08-08,0,0,1,2,2654
513,513,2011-08-09,0,0,1,-1,2653
514,514,2011-08-10,0,0,1,2,2655
515,515,2011-08-11,14,18,14,11,2666
516,516,2011-08-12,0,0,1,2,2668
517,517,2011-08-13,0,0,1,2,2670
518,518,2011-08-14,0,0,1,1,2671
519,519,2011-08-15,0,0,2,4,2675
520,520,2011-08-16,0,0,2,3,2678
521,521,2011-08-17,3,3,4,8,2686
522,522,2011-08-18,0,7,-6,6,2692
523,523,2011-08-19,1,3,0,0,2692
524,524,2011-08-20,8,22,-3,26,2718
525,525,2011-08-22,6,7,7,-4,2714
526,526,2011-08-23,2,7,-1,6,2720
527,527,2011-08-24,0,0,1,0,2720
528,528,2011-08-25,209,223,196,392,3112
529,529,2011-08-26,0,0,3,1,3113
530,530,2011-08-28,2,3,3,6,3119
531,531,2011-08-29,0,0,3,6,3125
532,532,2011-08-30,8,13,5,-10,3115
533,533,2011-08-31,0,1,3,2,3117
534,534,2011-09-01,0,0,1,2,3119
535,535,2011-09-02,0,0,1,1,3120
536,536,2011-09-03,4,5,7,12,3132
537,537,2011-09-04,1,2,3,1,3133
538,538,2011-09-06,1,3,0,0,3133
539,539,2011-09-07,0,0,3,6,3139
540,540,2011-09-08,1,3,1,2,3141
541,541,2011-09-09,0,0,4,4,3145
542,542,2011-09-11,2,2,4,8,3153
543,543,2011-09-12,0,0,2,1,3154
544,544,2011-09-13,1,2,4,2,3156
545,545,2011-09-14,0,0,2,4,3160
546,546,2011-09-15,0,0,1,-1,3159
547,547,2011-09-16,0,0,1,2,3161
548,548,2011-09-17,4,7,5,10,3171
549,549,2011-09-18,4,10,2,3,3174
550,550,2011-09-20,0,0,2,4,3178
551,551,2011-09-21,4,5,8,11,3189
552,552,2011-09-22,2,9,-2,7,3196
553,553,2011-09-23,0,0,1,2,3198
554,554,2011-09-24,0,0,1,2,3200
555,555,2011-09-25,81,108,59,116,3316
556,556,2011-09-27,0,1,2,2,3318
557,557,2011-09-28,0,1,2,4,3322
558,558,2011-09-30,4,4,5,5,3327
559,559,2011-10-01,0,0,1,2,3329
560,560,2011-10-02,0,1,0,0,3329
561,561,2011-10-03,1,1,3,2,3331
562,562,2011-10-04,5,14,-3,6,3337
563,563,2011-10-06,1,2,3,6,3343
564,564,2011-10-08,5,7,6,12,3355
565,565,2011-10-09,5,7,6,5,3360
566,566,2011-10-10,12,14,12,-24,3336
567,567,2011-10-12,0,0,1,0,3336
568,568,2011-10-13,5,13,-1,10,3346
569,569,2011-10-14,0,1,1,1,3347
570,570,2011-10-16,0,0,2,3,3350
571,571,2011-10-17,0,0,2,4,3354
572,572,2011-10-18,1,4,2,3,3357
573,573,2011-10-19,3,3,6,10,3367
574,574,2011-10-20,0,0,1,1,3368
575,575,2011-10-22,0,0,1,0,3368
576,576,2011-10-23,0,0,1,2,3370
577,577,2011-10-24,0,0,1,1,3371
578,578,2011-10-25,5,5,7,14,3385
579,579,2011-10-27,0,0,1,2,3387
580,580,2011-10-28,2,2,6,12,3399
581,581,2011-10-31,0,0,2,3,3402
582,582,2011-11-01,0,0,2,4,3406
583,583,2011-11-02,0,0,2,3,3409
584,584,2011-11-03,0,0,2,4,3413
585,585,2011-11-04,1,1,2,4,3417
586,586,2011-11-05,4,12,-2,6,3423
587,587,2011-11-06,0,1,0,0,3423
588,588,2011-11-07,4,5,7,14,3437
589,589,2011-11-08,0,1,0,0,3437
590,590,2011-11-09,1,2,1,2,3439
591,591,2011-11-10,0,2,-1,-2,3437
592,592,2011-11-11,43,46,44,81,3518
593,593,2011-11-12,2,2,3,3,3521
594,594,2011-11-14,0,0,3,4,3525
595,595,2011-11-15,0,0,1,2,3527
596,596,2011-11-16,22,28,19,-13,3514
597,597,2011-11-17,0,0,2,3,3517
598,598,2011-11-18,0,0,2,1,3518
599,599,2011-11-19,0,0,1,2,3520
600,600,2011-11-21,0,0,1,0,3520
601,601,2011-11-22,6,8,6,1,3521
602,602,2011-11-25,2,2,6,12,3533
603,603,2011-11-26,1,2,1,0,3533
604,604,2011-11-27,2,3,3,2,3535
605,605,2011-11-28,11,11,16,-17,3518
606,606,2011-11-29,2,10,-4,7,3525
607,607,2011-12-01,0,0,2,1,3526
608,608,2011-12-02,3,4,3,6,3532
609,609,2011-12-04,46,68,77,60,3592
610,610,2011-12-05,0,0,3,6,3598
611,611,2011-12-06,3,7,0,0,3598
612,612,2011-12-07,0,0,1,2,3600
613,613,2011-12-08,1,2,3,6,3606
614,614,2011-12-09,0,0,1,2,3608
615,615,2011-12-10,4,6,3,-3,3605
616,616,2011-12-11,0,0,1,2,3607
617,617,2011-12-12,0,2,-1,-2,3605
618,618,2011-12-13,3,4,4,6,3611
619,619,2011-12-14,2,3,2,0,3611
620,620,2011-12-15,0,0,1,2,3613
621,621,2011-12-16,0,0,1,2,3615
622,622,2011-12-17,0,5,-4,8,3623
623,623,2011-12-18,0,0,1,2,3625
624,624,2011-12-19,6,11,5,6,3631
625,625,2011-12-20,5,6,8,16,3647
626,626,2011-12-22,0,2,0,3,3650
627,627,2011-12-23,3,4,4,8,3658
628,628,2011-12-24,0,0,1,2,3660
629,629,2011-12-25,0,0,1,2,3662
630,630,2011-12-26,1,1,3,6,3668
631,631,2011-12-27,0,0,2,4,3672
632,632,2011-12-28,1,2,2,1,3673
633,633,2011-12-29,1,1,2,4,3677
634,634,2011-12-30,0,0,2,3,3680
635,635,2011-12-31,13,20,14,12,3692
636,636,2012-01-02,2,2,4,8,3700
637,637,2012-01-03,5,12,2,5,3705
638,638,2012-01-04,0,1,0,0,3705
639,639,2012-01-05,1,2,6,7,3712
640,640,2012-01-06,12,17,14,32,3744
641,641,2012-01-07,2,6,-1,2,3746
642,642,2012-01-08,0,0,2,4,3750
643,643,2012-01-10,4,4,7,13,3763
644,644,2012-01-11,10,14,11,2,3765
645,645,2012-01-12,0,0,1,2,3767
646,646,2012-01-13,1,2,4,3,3770
647,647,2012-01-14,1,2,1,0,3770
648,648,2012-01-15,0,0,3,5,3775
649,649,2012-01-16,2,3,5,7,3782
650,650,2012-01-18,0,14,-13,26,3808
651,651,2012-01-19,9,9,11,22,3830
652,652,2012-01-20,1,3,4,6,3836
653,653,2012-01-21,0,0,1,2,3838
654,654,2012-01-22,0,0,2,0,3838
655,655,2012-01-24,1,3,2,1,3839
656,656,2012-01-25,0,0,2,3,3842
657,657,2012-01-26,0,0,1,2,3844
658,658,2012-01-27,0,0,2,3,3847
659,659,2012-01-28,0,0,2,4,3851
660,660,2012-01-29,1,1,3,2,3853
661,661,2012-01-31,0,1,0,0,3853
662,662,2012-02-01,0,2,1,2,3855
663,663,2012-02-02,3,3,6,3,3858
664,664,2012-02-03,0,0,2,4,3862
665,665,2012-02-04,0,0,2,3,3865
666,666,2012-02-05,1,2,1,-1,3864
667,667,2012-02-06,5,13,1,10,3874
668,668,2012-02-08,0,0,3,6,3880
669,669,2012-02-09,0,0,1,2,3882
670,670,2012-02-10,0,0,1,2,3884
671,671,2012-02-11,65,80,52,98,3982
672,672,2012-02-13,8,11,6,6,3988
673,673,2012-02-14,0,0,3,6,3994
674,674,2012-02-15,0,0,2,4,3998
675,675,2012-02-16,0,0,1,2,4000
676,676,2012-02-17,0,0,2,4,4004
677,677,2012-02-20,0,0,1,2,4006
678,678,2012-02-23,1,3,0,0,4006
679,679,2012-02-24,1,1,2,2,4008
680,680,2012-02-25,2,3,2,4,4012
681,681,2012-02-26,0,1,0,0,4012
682,682,2012-02-27,0,0,1,0,4012
683,683,2012-02-28,0,0,3,0,4012
684,684,2012-02-29,0,0,1,2,4014
685,685,2012-03-02,0,1,1,2,4016
686,686,2012-03-03,1,2,3,-1,4015
687,687,2012-03-04,42,46,40,80,4095
688,688,2012-03-05,0,1,0,0,4095
689,689,2012-03-06,0,0,1,1,4096
690,690,2012-03-07,0,0,2,4,4100
691,691,2012-03-09,2,3,2,-2,4098
692,692,2012-03-10,9,9,10,20,4118
693,693,2012-03-11,0,0,2,4,4122
694,694,2012-03-12,0,0,2,3,4125
695,695,2012-03-13,4,6,6,2,4127
696,696,2012-03-14,6,7,9,18,4145
697,697,2012-03-15,0,0,3,6,4151
698,698,2012-03-16,1,1,2,4,4155
699,699,2012-03-18,0,1,6,10,4165
700,700,2012-03-20,7,9,8,12,4177
701,701,2012-03-21,0,0,2,4,4181
702,702,2012-03-22,0,0,1,2,4183
703,703,2012-03-24,0,0,1,2,4185
704,704,2012-03-26,0,1,1,2,4187
705,705,2012-03-28,0,0,2,4,4191
706,706,2012-03-29,0,0,2,2,4193
707,707,2012-03-30,0,0,2,3,4196
708,708,2012-03-31,1,1,2,-4,4192
709,709,2012-04-02,1,3,1,2,4194
710,710,2012-04-06,0,0,2,4,4198
711,711,2012-04-07,0,0,1,2,4200
712,712,2012-04-08,0,0,4,6,4206
713,713,2012-04-09,1,3,1,-2,4204
714,714,2012-04-10,0,0,1,2,4206
715,715,2012-04-11,0,0,4,8,4214
716,716,2012-04-12,3,5,4,6,4220
717,717,2012-04-13,0,0,3,5,4225
718,718,2012-04-15,0,0,1,2,4227
719,719,2012-04-16,3,4,5,4,4231
720,720,2012-04-17,11,13,12,12,4243
721,721,2012-04-18,0,0,1,2,4245
722,722,2012-04-19,0,0,3,6,4251
723,723,2012-04-20,0,1,1,2,4253
724,724,2012-04-21,0,0,1,-1,4252
725,725,2012-04-23,0,0,1,2,4254
726,726,2012-04-24,0,0,1,2,4256
727,727,2012-04-25,0,0,1,-1,4255
728,728,2012-04-26,1,2,1,0,4255
729,729,2012-04-28,1,2,1,2,4257
730,730,2012-04-29,2,4,3,6,4263
731,731,2012-04-30,1,2,2,2,4265
732,732,2012-05-01,0,0,2,4,4269
733,733,2012-05-03,0,0,1,0,4269
734,734,2012-05-04,6,10,9,8,4277
735,735,2012-05-07,1,1,2,4,4281
736,736,2012-05-08,0,1,3,5,4286
737,737,2012-05-09,1,2,1,-2,4284
738,738,2012-05-10,0,1,4,6,4290
739,739,2012-05-11,0,0,1,2,4292
740,740,2012-05-12,4,12,-2,8,4300
741,741,2012-05-13,0,0,1,2,4302
742,742,2012-05-14,0,1,0,0,4302
743,743,2012-05-15,1,1,2,4,4306
744,744,2012-05-16,1,2,4,2,4308
745,745,2012-05-17,2,3,4,6,4314
746,746,2012-05-18,0,1,3,0,4314
747,747,2012-05-20,1,1,2,0,4314
748,748,2012-05-21,0,1,1,2,4316
749,749,2012-05-22,0,0,1,1,4317
750,750,2012-05-23,2,5,1,1,4318
751,751,2012-05-24,6,9,6,7,4325
752,752,2012-05-25,5,10,3,4,4329
753,753,2012-05-26,0,0,1,2,4331
754,754,2012-05-27,3,3,5,0,4331
755,755,2012-05-28,0,0,2,4,4335
756,756,2012-05-29,0,0,1,2,4337
757,757,2012-06-01,0,0,1,2,4339
758,758,2012-06-03,0,0,2,1,4340
759,759,2012-06-04,0,1,1,1,4341
760,760,2012-06-06,1,3,3,8,4349
761,761,2012-06-07,1,2,3,3,4352
762,762,2012-06-08,0,0,1,2,4354
763,763,2012-06-10,0,0,2,4,4358
764,764,2012-06-11,0,0,3,6,4364
765,765,2012-06-12,0,1,0,0,4364
766,766,2012-06-13,4,4,5,10,4374
767,767,2012-06-17,1,2,4,6,4380
768,768,2012-06-18,0,2,-1,1,4381
769,769,2012-06-19,1,1,5,7,4388
770,770,2012-06-20,2,3,4,6,4394
771,771,2012-06-21,0,2,3,3,4397
772,772,2012-06-22,2,8,0,5,4402
773,773,2012-06-23,0,0,1,2,4404
774,774,2012-06-24,6,7,8,15,4419
775,775,2012-06-26,3,5,2,4,4423
776,776,2012-06-27,0,0,1,2,4425
777,777,2012-06-28,4,6,5,7,4432
778,778,2012-06-29,1,1,3,6,4438
779,779,2012-06-30,0,0,2,4,4442
780,780,2012-07-01,0,0,2,4,4446
781,781,2012-07-02,0,0,1,2,4448
782,782,2012-07-03,0,0,1,0,4448
783,783,2012-07-05,0,0,2,4,4452
784,784,2012-07-06,0,1,2,3,4455
785,785,2012-07-07,1,1,3,6,4461
786,786,2012-07-09,13,14,13,26,4487
787,787,2012-07-10,0,0,1,1,4488
788,788,2012-07-11,2,3,3,-2,4486
789,789,2012-07-12,0,0,2,4,4490
790,790,2012-07-13,0,0,1,2,4492
791,791,2012-07-16,0,0,2,2,4494
792,792,2012-07-17,0,0,1,2,4496
793,793,2012-07-18,0,1,4,6,4502
794,794,2012-07-19,1,2,1,2,4504
795,795,2012-07-20,1,2,3,1,4505
796,796,2012-07-21,0,0,1,1,4506
797,797,2012-07-22,0,6,-5,5,4511
798,798,2012-07-23,0,2,1,2,4513
799,799,2012-07-24,0,0,1,1,4514
800,800,2012-07-25,1,2,2,4,4518
801,801,2012-07-26,2,2,6,12,4530
802,802,2012-07-27,0,0,1,1,4531
803,803,2012-07-28,135,154,118,-232,4299
804,804,2012-07-29,115,145,88,87,4386
805,805,2012-07-30,0,0,4,8,4394
806,806,2012-08-01,58,90,35,69,4463
807,807,2012-08-02,0,0,1,2,4465
808,808,2012-08-03,0,2,0,3,4468
809,809,2012-08-04,3,7,3,6,4474
810,810,2012-08-05,0,0,1,2,4476
811,811,2012-08-06,0,0,1,2,4478
812,812,2012-08-07,7,11,8,4,4482
813,813,2012-08-08,0,0,1,1,4483
814,814,2012-08-09,0,1,4,8,4491
815,815,2012-08-10,3,6,5,9,4500
816,816,2012-08-11,1,1,4,6,4506
817,817,2012-08-12,2,5,7,20,4526
818,818,2012-08-13,0,0,1,2,4528
819,819,2012-08-14,1,1,2,4,4532
820,820,2012-08-15,0,0,1,2,4534
821,821,2012-08-16,0,0,5,8,4542
822,822,2012-08-18,0,0,1,2,4544
823,823,2012-08-19,1,1,2,4,4548
824,824,2012-08-20,0,0,2,4,4552
825,825,2012-08-21,0,0,1,0,4552
826,826,2012-08-22,0,1,2,4,4556
827,827,2012-08-23,3,9,2,11,4567
828,828,2012-08-24,0,0,1,2,4569
829,829,2012-08-25,0,0,1,1,4570
830,830,2012-08-26,2,4,3,6,4576
831,831,2012-08-27,0,1,0,0,4576
832,832,2012-08-28,0,0,3,6,4582
833,833,2012-08-29,8,13,5,4,4586
834,834,2012-08-30,0,1,2,4,4590
835,835,2012-08-31,5,7,6,2,4592
836,836,2012-09-01,1,3,3,5,4597
837,837,2012-09-02,0,0,1,2,4599
838,838,2012-09-03,0,0,2,4,4603
839,839,2012-09-04,0,0,2,4,4607
840,840,2012-09-05,3,4,4,5,4612
841,841,2012-09-06,0,0,2,3,4615
842,842,2012-09-07,12,12,16,30,4645
843,843,2012-09-08,0,0,2,4,4649
844,844,2012-09-09,1,2,1,-1,4648
845,845,2012-09-10,1,1,3,6,4654
846,846,2012-09-11,0,0,2,4,4658
847,847,2012-09-13,0,0,1,2,4660
848,848,2012-09-16,0,0,1,2,4662
849,849,2012-09-18,0,4,0,6,4668
850,850,2012-09-19,0,0,2,4,4672
851,851,2012-09-20,6,6,11,14,4686
852,852,2012-09-21,2,3,5,5,4691
853,853,2012-09-22,0,0,2,2,4693
854,854,2012-09-24,0,0,1,2,4695
855,855,2012-09-25,0,0,1,2,4697
856,856,2012-09-26,0,0,2,3,4700
857,857,2012-09-27,2,4,3,2,4702
858,858,2012-09-28,0,3,0,6,4708
859,859,2012-09-30,0,0,2,2,4710
860,860,2012-10-01,0,0,1,2,4712
861,861,2012-10-02,0,0,2,2,4714
862,862,2012-10-03,3,6,8,22,4736
863,863,2012-10-04,1,2,2,4,4740
864,864,2012-10-05,0,0,1,2,4742
865,865,2012-10-08,0,0,3,6,4748
866,866,2012-10-10,1,4,0,4,4752
867,867,2012-10-11,0,0,3,4,4756
868,868,2012-10-12,0,0,1,2,4758
869,869,2012-10-13,1,1,2,4,4762
870,870,2012-10-14,1,1,5,8,4770
871,871,2012-10-16,0,0,1,2,4772
872,872,2012-10-17,0,1,1,1,4773
873,873,2012-10-18,0,7,-5,13,4786
874,874,2012-10-19,3,6,2,4,4790
875,875,2012-10-21,0,0,1,2,4792
876,876,2012-10-22,2,2,6,11,4803
877,877,2012-10-23,0,0,1,2,4805
878,878,2012-10-25,1,2,4,5,4810
879,879,2012-10-28,4,4,9,12,4822
880,880,2012-10-29,0,2,4,6,4828
881,881,2012-10-31,6,6,8,16,4844
882,882,2012-11-01,13,17,14,-12,4832
883,883,2012-11-02,1,9,-4,16,4848
884,884,2012-11-03,12,14,12,-9,4839
885,885,2012-11-04,0,4,-3,6,4845
886,886,2012-11-05,1,2,2,1,4846
887,887,2012-11-06,4,10,1,2,4848
888,888,2012-11-07,0,0,2,1,4849
889,889,2012-11-09,2,3,4,5,4854
890,890,2012-11-10,8,11,7,14,4868
891,891,2012-11-11,6,6,11,20,4888
892,892,2012-11-12,0,0,3,6,4894
893,893,2012-11-13,0,0,6,7,4901
894,894,2012-11-14,0,0,4,8,4909
895,895,2012-11-15,0,0,5,7,4916
896,896,2012-11-16,4,7,5,1,4917
897,897,2012-11-17,2,4,6,11,4928
898,898,2012-11-18,0,0,2,4,4932
899,899,2012-11-19,1,1,3,0,4932
900,900,2012-11-20,2,2,4,5,4937
901,901,2012-11-22,0,0,1,2,4939
902,902,2012-11-23,0,0,1,2,4941
903,903,2012-11-24,1,4,2,4,4945
904,904,2012-11-25,2,4,8,14,4959
905,905,2012-11-26,7,8,12,14,4973
906,906,2012-11-27,1,4,9,13,4986
907,907,2012-11-28,0,1,4,8,4994
908,908,2012-11-29,0,2,4,5,4999
909,909,2012-11-30,1,3,6,9,5008
910,910,2012-12-01,1,1,5,6,5014
911,911,2012-12-02,0,0,4,8,5022
912,912,2012-12-03,2,5,6,4,5026
913,913,2012-12-04,0,0,6,11,5037
914,914,2012-12-05,1,3,3,5,5042
915,915,2012-12-06,1,2,1,-1,5041
916,916,2012-12-07,1,2,8,10,5051
917,917,2012-12-08,0,0,9,17,5068
918,918,2012-12-09,2,3,6,8,5076
919,919,2012-12-10,1,4,1,2,5078
920,920,2012-12-11,0,0,10,15,5093
921,921,2012-12-12,0,0,4,7,5100
922,922,2012-12-13,2,3,4,8,5108
923,923,2012-12-14,7,9,7,5,5113
924,924,2012-12-15,1,8,3,26,5139
925,925,2012-12-16,2,2,8,14,5153
926,926,2012-12-17,2,3,7,13,5166
927,927,2012-12-18,1,1,7,7,5173
928,928,2012-12-19,1,1,4,8,5181
929,929,2012-12-20,0,0,1,2,5183
930,930,2012-12-21,1,3,4,11,5194
931,931,2012-12-22,0,3,0,8,5202
932,932,2012-12-23,0,0,1,2,5204
933,933,2012-12-24,0,0,4,4,5208
934,934,2012-12-25,0,2,1,3,5211
935,935,2012-12-26,1,2,3,2,5213
936,936,2012-12-27,1,3,7,9,5222
937,937,2012-12-28,11,16,16,-3,5219
938,938,2012-12-29,26,31,29,-25,5194
939,939,2012-12-30,3,4,8,12,5206
940,940,2012-12-31,0,2,4,5,5211
941,941,2013-01-01,1,1,2,2,5213
942,942,2013-01-02,0,1,2,3,5216
943,943,2013-01-03,2,3,8,11,5227
944,944,2013-01-04,6,8,18,27,5254
945,945,2013-01-05,1,1,5,3,5257
946,946,2013-01-06,3,6,5,5,5262
947,947,2013-01-07,1,3,4,8,5270
948,948,2013-01-08,6,9,11,14,5284
949,949,2013-01-09,1,1,5,10,5294
950,950,2013-01-10,2,5,7,4,5298
951,951,2013-01-11,0,0,6,7,5305
952,952,2013-01-12,1,4,3,8,5313
953,953,2013-01-13,2,5,4,10,5323
954,954,2013-01-14,2,4,9,12,5335
955,955,2013-01-15,2,3,13,24,5359
956,956,2013-01-16,0,0,5,9,5368
957,957,2013-01-17,3,9,8,13,5381
958,958,2013-01-18,3,3,9,16,5397
959,959,2013-01-19,2,9,4,11,5408
960,960,2013-01-20,0,0,1,2,5410
961,961,2013-01-21,0,0,1,1,5411
962,962,2013-01-22,2,3,3,6,5417
963,963,2013-01-23,1,1,8,15,5432
964,964,2013-01-24,6,6,12,24,5456
965,965,2013-01-25,1,2,8,13,5469
966,966,2013-01-26,3,7,2,6,5475
967,967,2013-01-27,1,2,2,4,5479
968,968,2013-01-28,5,9,8,15,5494
969,969,2013-01-29,4,5,8,14,5508
970,970,2013-01-30,4,12,0,8,5516
971,971,2013-01-31,0,3,8,14,5530
972,972,2013-02-01,0,0,1,0,5530
973,973,2013-02-02,0,7,-5,12,5542
974,974,2013-02-03,0,0,4,6,5548
975,975,2013-02-04,1,2,3,6,5554
976,976,2013-02-05,6,6,11,22,5576
977,977,2013-02-06,3,3,5,-2,5574
978,978,2013-02-07,15,18,20,30,5604
979,979,2013-02-08,0,0,4,7,5611
980,980,2013-02-09,0,0,1,2,5613
981,981,2013-02-10,0,0,2,4,5617
982,982,2013-02-11,11,11,16,19,5636
983,983,2013-02-12,0,3,1,8,5644
984,984,2013-02-13,1,2,7,7,5651
985,985,2013-02-14,0,0,2,3,5654
986,986,2013-02-15,1,2,4,7,5661
987,987,2013-02-16,0,1,0,0,5661
988,988,2013-02-17,2,4,7,11,5672
989,989,2013-02-18,2,5,11,25,5697
990,990,2013-02-19,0,0,1,-2,5695
991,991,2013-02-20,1,5,10,16,5711
992,992,2013-02-21,13,13,25,35,5746
993,993,2013-02-22,6,7,14,24,5770
994,994,2013-02-23,2,3,11,18,5788
995,995,2013-02-24,8,9,15,26,5814
996,996,2013-02-25,0,0,2,3,5817
997,997,2013-02-26,6,7,14,6,5823
998,998,2013-02-27,0,1,4,7,5830
999,999,2013-02-28,0,1,1,2,5832
1000,1000,2013-03-01,6,9,7,0,5832
1001,1001,2013-03-02,5,11,7,14,5846
1002,1002,2013-03-03,4,7,5,9,5855
1003,1003,2013-03-04,4,6,11,15,5870
1004,1004,2013-03-05,3,4,7,12,5882
1005,1005,2013-03-06,2,2,4,8,5890
1006,1006,2013-03-07,10,14,13,13,5903
1007,1007,2013-03-08,2,3,7,13,5916
1008,1008,2013-03-09,4,7,6,12,5928
1009,1009,2013-03-10,0,0,3,6,5934
1010,1010,2013-03-11,1,1,8,12,5946
1011,1011,2013-03-12,7,12,7,0,5946
1012,1012,2013-03-13,2,3,6,11,5957
1013,1013,2013-03-14,3,5,7,9,5966
1014,1014,2013-03-15,1,4,4,11,5977
1015,1015,2013-03-17,0,0,6,11,5988
1016,1016,2013-03-18,5,7,9,17,6005
1017,1017,2013-03-19,0,1,3,6,6011
1018,1018,2013-03-20,3,4,11,22,6033
1019,1019,2013-03-21,3,5,8,15,6048
1020,1020,2013-03-22,1,3,6,9,6057
1021,1021,2013-03-23,2,5,5,8,6065
1022,1022,2013-03-24,0,1,3,5,6070
1023,1023,2013-03-25,0,0,6,12,6082
1024,1024,2013-03-26,11,13,15,-10,6072
1025,1025,2013-03-27,1,2,3,6,6078
1026,1026,2013-03-28,4,4,11,4,6082
1027,1027,2013-03-29,7,12,10,18,6100
1028,1028,2013-03-30,0,0,2,4,6104
1029,1029,2013-03-31,0,0,1,2,6106
1030,1030,2013-04-01,0,0,1,2,6108
1031,1031,2013-04-02,0,0,4,6,6114
1032,1032,2013-04-03,2,4,6,12,6126
1033,1033,2013-04-05,2,5,8,10,6136
1034,1034,2013-04-06,0,2,4,7,6143
1035,1035,2013-04-07,0,2,4,8,6151
1036,1036,2013-04-08,0,0,4,8,6159
1037,1037,2013-04-09,12,13,17,30,6189
1038,1038,2013-04-11,6,8,11,-3,6186
1039,1039,2013-04-12,0,0,6,9,6195
1040,1040,2013-04-13,2,3,5,10,6205
1041,1041,2013-04-14,2,5,3,5,6210
1042,1042,2013-04-15,5,5,10,17,6227
1043,1043,2013-04-16,0,0,1,1,6228
1044,1044,2013-04-17,0,1,12,17,6245
1045,1045,2013-04-18,0,1,5,10,6255
1046,1046,2013-04-19,0,1,6,11,6266
1047,1047,2013-04-20,4,5,7,3,6269
1048,1048,2013-04-21,1,1,3,5,6274
1049,1049,2013-04-22,0,0,2,4,6278
1050,1050,2013-04-23,2,7,4,10,6288
1051,1051,2013-04-24,0,0,5,10,6298
1052,1052,2013-04-25,0,1,2,3,6301
1053,1053,2013-04-26,2,5,9,9,6310
1054,1054,2013-04-27,4,5,14,20,6330
1055,1055,2013-04-28,0,0,4,8,6338
1056,1056,2013-04-29,0,1,2,4,6342
1057,1057,2013-04-30,2,5,6,12,6354
1058,1058,2013-05-01,1,2,7,12,6366
1059,1059,2013-05-02,0,0,3,3,6369
1060,1060,2013-05-03,34,37,42,82,6451
1061,1061,2013-05-04,1,4,2,3,6454
1062,1062,2013-05-05,0,2,1,2,6456
1063,1063,2013-05-06,1,1,7,11,6467
1064,1064,2013-05-07,1,2,5,9,6476
1065,1065,2013-05-08,0,0,1,2,6478
1066,1066,2013-05-09,3,3,12,18,6496
1067,1067,2013-05-10,0,2,4,7,6503
1068,1068,2013-05-12,4,11,3,13,6516
1069,1069,2013-05-13,1,1,6,8,6524
1070,1070,2013-05-14,1,1,9,16,6540
1071,1071,2013-05-15,2,4,5,3,6543
1072,1072,2013-05-16,0,0,3,6,6549
1073,1073,2013-05-17,2,7,4,8,6557
1074,1074,2013-05-18,0,0,1,2,6559
1075,1075,2013-05-19,4,8,7,13,6572
1076,1076,2013-05-20,2,2,6,8,6580
1077,1077,2013-05-21,1,1,5,0,6580
1078,1078,2013-05-22,6,8,11,19,6599
1079,1079,2013-05-23,0,1,6,8,6607
1080,1080,2013-05-24,0,0,4,6,6613
1081,1081,2013-05-25,2,3,9,12,6625
1082,1082,2013-05-26,0,0,2,1,6626
1083,1083,2013-05-27,0,2,1,2,6628
1084,1084,2013-05-28,5,9,8,11,6639
1085,1085,2013-05-29,0,0,2,4,6643
1086,1086,2013-05-30,2,3,10,18,6661
1087,1087,2013-05-31,4,4,9,14,6675
1088,1088,2013-06-01,4,5,9,12,6687
1089,1089,2013-06-02,4,6,4,-1,6686
1090,1090,2013-06-03,0,0,3,2,6688
1091,1091,2013-06-04,0,0,3,5,6693
1092,1092,2013-06-05,0,3,2,7,6700
1093,1093,2013-06-06,0,0,7,9,6709
1094,1094,2013-06-07,4,13,1,16,6725
1095,1095,2013-06-08,10,13,11,22,6747
1096,1096,2013-06-09,5,7,7,14,6761
1097,1097,2013-06-10,3,7,5,15,6776
1098,1098,2013-06-11,3,6,12,23,6799
1099,1099,2013-06-12,0,2,5,10,6809
1100,1100,2013-06-13,1,1,9,16,6825
1101,1101,2013-06-14,0,1,5,8,6833
1102,1102,2013-06-15,2,3,5,10,6843
1103,1103,2013-06-16,1,2,9,14,6857
1104,1104,2013-06-17,1,1,6,12,6869
1105,1105,2013-06-18,1,2,7,12,6881
1106,1106,2013-06-19,2,2,9,14,6895
1107,1107,2013-06-20,0,0,1,2,6897
1108,1108,2013-06-21,9,10,17,23,6920
1109,1109,2013-06-22,0,0,1,2,6922
1110,1110,2013-06-23,3,7,4,8,6930
1111,1111,2013-06-24,0,2,1,4,6934
1112,1112,2013-06-25,1,4,4,4,6938
1113,1113,2013-06-26,17,25,23,8,6946
1114,1114,2013-06-27,1,2,8,15,6961
1115,1115,2013-06-28,0,1,4,4,6965
1116,1116,2013-06-29,1,2,5,7,6972
1117,1117,2013-06-30,0,0,1,2,6974
1118,1118,2013-07-01,0,0,3,4,6978
1119,1119,2013-07-02,2,4,7,11,6989
1120,1120,2013-07-03,3,6,9,12,7001
1121,1121,2013-07-04,4,9,5,7,7008
1122,1122,2013-07-05,2,3,2,4,7012
1123,1123,2013-07-06,0,0,2,4,7016
1124,1124,2013-07-07,0,0,4,8,7024
1125,1125,2013-07-08,16,20,17,34,7058
1126,1126,2013-07-09,1,2,9,17,7075
1127,1127,2013-07-10,2,4,6,4,7079
1128,1128,2013-07-12,1,6,0,4,7083
1129,1129,2013-07-13,3,5,10,16,7099
1130,1130,2013-07-14,2,6,5,12,7111
1131,1131,2013-07-15,54,57,54,108,7219
1132,1132,2013-07-16,0,0,3,6,7225
1133,1133,2013-07-17,1,1,4,1,7226
1134,1134,2013-07-18,0,2,2,3,7229
1135,1135,2013-07-19,2,5,8,13,7242
1136,1136,2013-07-20,2,7,1,10,7252
1137,1137,2013-07-21,1,1,9,12,7264
1138,1138,2013-07-22,5,5,14,28,7292
1139,1139,2013-07-23,8,9,16,28,7320
1140,1140,2013-07-24,5,8,7,13,7333
1141,1141,2013-07-25,4,5,11,14,7347
1142,1142,2013-07-26,1,1,5,9,7356
1143,1143,2013-07-27,1,6,2,6,7362
1144,1144,2013-07-28,36,57,24,41,7403
1145,1145,2013-07-29,0,0,1,2,7405
1146,1146,2013-07-30,2,7,7,12,7417
1147,1147,2013-07-31,0,5,0,1,7418
1148,1148,2013-08-01,0,0,3,5,7423
1149,1149,2013-08-02,0,1,4,8,7431
1150,1150,2013-08-03,5,7,11,21,7452
1151,1151,2013-08-05,12,14,16,-20,7432
1152,1152,2013-08-06,6,11,8,16,7448
1153,1153,2013-08-07,1,3,4,4,7452
1154,1154,2013-08-08,0,4,0,7,7459
1155,1155,2013-08-09,2,2,9,15,7474
1156,1156,2013-08-10,2,5,5,8,7482
1157,1157,2013-08-11,4,7,7,8,7490
1158,1158,2013-08-12,0,0,6,8,7498
1159,1159,2013-08-13,0,1,4,6,7504
1160,1160,2013-08-14,0,2,6,12,7516
1161,1161,2013-08-15,2,4,4,2,7518
1162,1162,2013-08-16,1,2,3,4,7522
1163,1163,2013-08-17,2,2,5,1,7523
1164,1164,2013-08-18,0,0,1,2,7525
1165,1165,2013-08-19,0,1,5,9,7534
1166,1166,2013-08-20,7,12,11,16,7550
1167,1167,2013-08-21,0,0,2,3,7553
1168,1168,2013-08-22,0,2,5,10,7563
1169,1169,2013-08-23,1,1,5,10,7573
1170,1170,2013-08-24,2,2,6,8,7581
1171,1171,2013-08-25,0,0,4,8,7589
1172,1172,2013-08-26,0,0,2,4,7593
1173,1173,2013-08-27,0,1,1,2,7595
1174,1174,2013-08-28,2,4,6,12,7607
1175,1175,2013-08-29,1,4,9,13,7620
1176,1176,2013-08-30,2,7,6,19,7639
1177,1177,2013-08-31,0,0,4,6,7645
1178,1178,2013-09-01,1,2,4,5,7650
1179,1179,2013-09-02,4,6,26,46,7696
1180,1180,2013-09-03,0,1,4,7,7703
1181,1181,2013-09-04,7,9,8,-12,7691
1182,1182,2013-09-05,0,0,7,7,7698
1183,1183,2013-09-06,3,5,5,2,7700
1184,1184,2013-09-07,0,0,5,10,7710
1185,1185,2013-09-08,8,9,13,25,7735
1186,1186,2013-09-09,1,1,5,10,7745
1187,1187,2013-09-10,1,1,8,12,7757
1188,1188,2013-09-11,1,2,6,11,7768
1189,1189,2013-09-12,0,2,2,-1,7767
1190,1190,2013-09-13,1,1,5,10,7777
1191,1191,2013-09-14,0,0,2,0,7777
1192,1192,2013-09-15,0,0,6,9,7786
1193,1193,2013-09-16,2,6,2,4,7790
1194,1194,2013-09-17,19,23,19,10,7800
1195,1195,2013-09-18,1,1,7,4,7804
1196,1196,2013-09-19,5,5,14,23,7827
1197,1197,2013-09-20,3,9,5,18,7845
1198,1198,2013-09-21,0,0,2,1,7846
1199,1199,2013-09-22,1,1,6,9,7855
1200,1200,2013-09-23,1,3,5,10,7865
1201,1201,2013-09-24,4,5,8,11,7876
1202,1202,2013-09-25,4,5,5,2,7878
1203,1203,2013-09-26,2,2,7,8,7886
1204,1204,2013-09-27,1,6,3,12,7898
1205,1205,2013-09-28,2,3,5,7,7905
1206,1206,2013-09-29,1,4,3,5,7910
1207,1207,2013-09-30,0,1,1,2,7912
1208,1208,2013-10-01,0,0,1,2,7914
1209,1209,2013-10-02,3,4,19,29,7943
1210,1210,2013-10-03,19,25,21,26,7969
1211,1211,2013-10-04,1,1,5,10,7979
1212,1212,2013-10-05,0,0,2,4,7983
1213,1213,2013-10-07,0,1,5,6,7989
1214,1214,2013-10-08,9,9,17,31,8020
1215,1215,2013-10-09,8,11,16,28,8048
1216,1216,2013-10-10,0,1,3,6,8054
1217,1217,2013-10-11,21,26,29,54,8108
1218,1218,2013-10-12,3,5,10,18,8126
1219,1219,2013-10-13,1,2,7,13,8139
1220,1220,2013-10-14,3,5,7,10,8149
1221,1221,2013-10-15,1,1,3,6,8155
1222,1222,2013-10-16,2,2,7,14,8169
1223,1223,2013-10-17,0,1,2,4,8173
1224,1224,2013-10-18,9,12,18,32,8205
1225,1225,2013-10-20,1,1,8,12,8217
1226,1226,2013-10-21,2,3,9,15,8232
1227,1227,2013-10-22,4,7,9,22,8254
1228,1228,2013-10-23,4,4,7,-9,8245
1229,1229,2013-10-24,9,12,11,9,8254
1230,1230,2013-10-25,1,5,1,14,8268
1231,1231,2013-10-26,0,0,5,7,8275
1232,1232,2013-10-27,3,3,14,24,8299
1233,1233,2013-10-28,0,0,5,9,8308
1234,1234,2013-10-29,2,3,11,22,8330
1235,1235,2013-10-30,3,8,2,7,8337
1236,1236,2013-10-31,7,13,15,28,8365
1237,1237,2013-11-01,1,1,4,5,8370
1238,1238,2013-11-02,0,0,2,4,8374
1239,1239,2013-11-03,2,3,5,9,8383
1240,1240,2013-11-04,0,0,8,15,8398
1241,1241,2013-11-05,0,0,3,6,8404
1242,1242,2013-11-06,5,6,16,15,8419
1243,1243,2013-11-07,1,2,5,7,8426
1244,1244,2013-11-08,0,0,4,7,8433
1245,1245,2013-11-10,2,3,7,9,8442
1246,1246,2013-11-12,2,2,6,10,8452
1247,1247,2013-11-13,5,9,11,14,8466
1248,1248,2013-11-14,3,9,1,6,8472
1249,1249,2013-11-15,3,5,11,20,8492
1250,1250,2013-11-16,0,1,1,2,8494
1251,1251,2013-11-17,1,1,2,4,8498
1252,1252,2013-11-18,2,7,6,20,8518
1253,1253,2013-11-19,3,5,11,17,8535
1254,1254,2013-11-20,2,2,10,15,8550
1255,1255,2013-11-21,3,6,4,6,8556
1256,1256,2013-11-22,1,2,6,12,8568
1257,1257,2013-11-23,2,3,12,18,8586
1258,1258,2013-11-24,2,5,6,7,8593
1259,1259,2013-11-25,0,1,4,7,8600
1260,1260,2013-11-27,3,4,8,13,8613
1261,1261,2013-11-28,0,0,1,2,8615
1262,1262,2013-11-29,2,4,7,12,8627
1263,1263,2013-11-30,3,8,4,11,8638
1264,1264,2013-12-01,0,1,4,7,8645
1265,1265,2013-12-02,0,0,4,5,8650
1266,1266,2013-12-03,22,37,20,31,8681
1267,1267,2013-12-04,5,6,12,21,8702
1268,1268,2013-12-05,8,11,12,22,8724
1269,1269,2013-12-06,37,42,42,76,8800
1270,1270,2013-12-07,3,4,5,8,8808
1271,1271,2013-12-08,2,2,4,-4,8804
1272,1272,2013-12-09,5,7,12,18,8822
1273,1273,2013-12-10,2,2,12,21,8843
1274,1274,2013-12-11,3,4,7,12,8855
1275,1275,2013-12-12,4,6,16,21,8876
1276,1276,2013-12-13,6,7,14,18,8894
1277,1277,2013-12-14,3,8,7,11,8905
1278,1278,2013-12-15,0,0,4,5,8910
1279,1279,2013-12-16,4,7,13,18,8928
1280,1280,2013-12-17,0,0,6,11,8939
1281,1281,2013-12-18,0,0,5,5,8944
1282,1282,2013-12-19,0,1,4,5,8949
1283,1283,2013-12-20,1,4,3,8,8957
1284,1284,2013-12-21,1,2,5,10,8967
1285,1285,2013-12-22,51,78,31,26,8993
1286,1286,2013-12-23,4,7,9,13,9006
1287,1287,2013-12-24,29,30,31,62,9068
1288,1288,2013-12-25,0,0,2,4,9072
1289,1289,2013-12-26,3,5,9,8,9080
1290,1290,2013-12-27,2,2,12,9,9089
1291,1291,2013-12-28,3,4,8,12,9101
1292,1292,2013-12-29,5,7,10,14,9115
1293,1293,2013-12-30,5,6,13,15,9130
1294,1294,2013-12-31,11,11,19,12,9142
1295,1295,2014-01-01,0,3,7,14,9156
1296,1296,2014-01-02,2,5,2,4,9160
1297,1297,2014-01-03,6,8,13,22,9182
1298,1298,2014-01-04,4,6,10,14,9196
1299,1299,2014-01-05,1,3,7,13,9209
1300,1300,2014-01-06,1,3,7,11,9220
1301,1301,2014-01-07,34,39,37,70,9290
1302,1302,2014-01-08,1,5,2,4,9294
1303,1303,2014-01-09,0,0,6,7,9301
1304,1304,2014-01-10,6,9,14,17,9318
1305,1305,2014-01-11,15,15,19,37,9355
1306,1306,2014-01-12,1,1,3,2,9357
1307,1307,2014-01-13,16,21,24,20,9377
1308,1308,2014-01-14,0,2,9,1,9378
1309,1309,2014-01-15,0,2,7,15,9393
1310,1310,2014-01-16,9,10,16,4,9397
1311,1311,2014-01-17,2,3,3,6,9403
1312,1312,2014-01-18,4,8,6,8,9411
1313,1313,2014-01-19,5,7,11,15,9426
1314,1314,2014-01-20,42,46,52,97,9523
1315,1315,2014-01-21,8,11,19,35,9558
1316,1316,2014-01-22,26,34,34,61,9619
1317,1317,2014-01-23,1,2,8,14,9633
1318,1318,2014-01-24,0,0,4,8,9641
1319,1319,2014-01-25,12,12,17,23,9664
1320,1320,2014-01-26,3,3,6,10,9674
1321,1321,2014-01-27,7,9,15,26,9700
1322,1322,2014-01-28,8,10,14,20,9720
1323,1323,2014-01-29,3,3,6,12,9732
1324,1324,2014-01-30,12,18,22,18,9750
1325,1325,2014-01-31,6,10,14,19,9769
1326,1326,2014-02-01,0,0,3,6,9775
1327,1327,2014-02-03,2,5,4,11,9786
1328,1328,2014-02-04,6,7,15,26,9812
1329,1329,2014-02-05,1,2,10,13,9825
1330,1330,2014-02-06,2,2,8,13,9838
1331,1331,2014-02-07,10,12,17,24,9862
1332,1332,2014-02-08,2,3,6,12,9874
1333,1333,2014-02-09,1,1,7,10,9884
1334,1334,2014-02-10,2,2,10,14,9898
1335,1335,2014-02-11,6,8,14,4,9902
1336,1336,2014-02-12,1,2,10,18,9920
1337,1337,2014-02-13,9,13,18,35,9955
1338,1338,2014-02-14,11,13,15,18,9973
1339,1339,2014-02-15,5,7,13,22,9995
1340,1340,2014-02-16,2,4,10,15,10010
1341,1341,2014-02-17,0,0,5,4,10014
1342,1342,2014-02-18,6,12,16,21,10035
1343,1343,2014-02-19,2,6,3,10,10045
1344,1344,2014-02-20,1,2,2,4,10049
1345,1345,2014-02-21,4,5,8,3,10052
1346,1346,2014-02-22,1,1,3,2,10054
1347,1347,2014-02-23,4,4,16,25,10079
1348,1348,2014-02-24,4,7,14,24,10103
1349,1349,2014-02-25,6,8,15,20,10123
1350,1350,2014-02-26,5,5,10,17,10140
1351,1351,2014-02-27,2,4,15,26,10166
1352,1352,2014-02-28,9,12,14,22,10188
1353,1353,2014-03-01,0,1,4,8,10196
1354,1354,2014-03-02,0,0,5,8,10204
1355,1355,2014-03-03,0,0,8,13,10217
1356,1356,2014-03-04,0,2,12,24,10241
1357,1357,2014-03-05,1,1,7,8,10249
1358,1358,2014-03-06,1,4,4,2,10251
1359,1359,2014-03-07,0,1,10,15,10266
1360,1360,2014-03-08,3,3,12,-2,10264
1361,1361,2014-03-09,0,2,3,1,10265
1362,1362,2014-03-10,0,3,5,13,10278
1363,1363,2014-03-11,0,0,2,4,10282
1364,1364,2014-03-12,0,0,2,0,10282
1365,1365,2014-03-13,0,0,15,26,10308
1366,1366,2014-03-14,0,1,3,6,10314
1367,1367,2014-03-15,1,5,1,6,10320
1368,1368,2014-03-16,3,6,5,11,10331
1369,1369,2014-03-17,0,0,5,8,10339
1370,1370,2014-03-18,0,1,2,3,10342
1371,1371,2014-03-19,10,12,17,13,10355
1372,1372,2014-03-20,1,1,4,8,10363
1373,1373,2014-03-21,5,7,12,21,10384
1374,1374,2014-03-22,1,2,4,0,10384
1375,1375,2014-03-23,3,6,5,1,10385
1376,1376,2014-03-24,1,2,6,12,10397
1377,1377,2014-03-25,7,9,11,5,10402
1378,1378,2014-03-26,2,3,8,13,10415
1379,1379,2014-03-27,5,21,-2,-31,10384
1380,1380,2014-03-28,0,2,10,17,10401
1381,1381,2014-03-29,0,0,4,8,10409
1382,1382,2014-03-30,0,0,2,3,10412
1383,1383,2014-03-31,2,3,6,7,10419
1384,1384,2014-04-01,9,14,15,25,10444
1385,1385,2014-04-02,2,4,12,13,10457
1386,1386,2014-04-03,0,1,5,7,10464
1387,1387,2014-04-04,0,1,5,8,10472
1388,1388,2014-04-05,0,0,1,2,10474
1389,1389,2014-04-06,0,0,2,1,10475
1390,1390,2014-04-07,1,1,4,-4,10471
1391,1391,2014-04-08,2,3,6,11,10482
1392,1392,2014-04-09,0,1,7,9,10491
1393,1393,2014-04-10,3,4,13,23,10514
1394,1394,2014-04-11,1,2,5,8,10522
1395,1395,2014-04-12,38,45,39,59,10581
1396,1396,2014-04-13,0,0,3,4,10585
1397,1397,2014-04-14,1,2,10,11,10596
1398,1398,2014-04-15,0,0,6,6,10602
1399,1399,2014-04-16,8,9,20,39,10641
1400,1400,2014-04-17,2,4,11,18,10659
1401,1401,2014-04-18,0,0,4,8,10667
1402,1402,2014-04-19,0,0,1,2,10669
1403,1403,2014-04-20,1,4,5,11,10680
1404,1404,2014-04-21,1,2,3,5,10685
1405,1405,2014-04-22,3,6,10,10,10695
1406,1406,2014-04-23,0,0,6,8,10703
1407,1407,2014-04-24,1,4,8,17,10720
1408,1408,2014-04-25,1,1,8,16,10736
1409,1409,2014-04-26,0,0,4,8,10744
1410,1410,2014-04-27,3,4,4,-4,10740
1411,1411,2014-04-28,2,4,5,6,10746
1412,1412,2014-04-29,7,9,10,5,10751
1413,1413,2014-04-30,8,12,9,18,10769
1414,1414,2014-05-01,1,2,4,8,10777
1415,1415,2014-05-02,0,0,5,10,10787
1416,1416,2014-05-03,9,10,14,28,10815
1417,1417,2014-05-04,1,2,4,7,10822
1418,1418,2014-05-05,1,1,8,11,10833
1419,1419,2014-05-06,4,5,15,24,10857
1420,1420,2014-05-07,4,5,8,14,10871
1421,1421,2014-05-08,0,2,6,9,10880
1422,1422,2014-05-09,4,5,10,5,10885
1423,1423,2014-05-10,1,1,4,0,10885
1424,1424,2014-05-11,0,0,2,4,10889
1425,1425,2014-05-12,0,2,3,2,10891
1426,1426,2014-05-13,3,5,8,5,10896
1427,1427,2014-05-14,0,0,10,20,10916
1428,1428,2014-05-15,3,6,14,14,10930
1429,1429,2014-05-16,1,3,8,6,10936
1430,1430,2014-05-17,0,0,1,2,10938
1431,1431,2014-05-18,0,2,4,6,10944
1432,1432,2014-05-19,2,5,10,17,10961
1433,1433,2014-05-20,0,0,2,3,10964
1434,1434,2014-05-21,1,2,5,9,10973
1435,1435,2014-05-22,3,5,9,14,10987
1436,1436,2014-05-23,0,0,2,2,10989
1437,1437,2014-05-24,1,3,4,8,10997
1438,1438,2014-05-25,5,12,6,-1,10996
1439,1439,2014-05-26,7,9,11,5,11001
1440,1440,2014-05-27,2,3,10,12,11013
1441,1441,2014-05-28,0,0,5,6,11019
1442,1442,2014-05-29,5,7,16,6,11025
1443,1443,2014-05-30,1,3,4,7,11032
1444,1444,2014-05-31,5,7,5,-6,11026
1445,1445,2014-06-01,4,5,9,15,11041
1446,1446,2014-06-02,0,0,2,4,11045
1447,1447,2014-06-03,0,0,7,14,11059
1448,1448,2014-06-04,3,5,8,12,11071
1449,1449,2014-06-05,2,5,4,6,11077
1450,1450,2014-06-06,2,4,5,0,11077
1451,1451,2014-06-07,0,0,6,9,11086
1452,1452,2014-06-08,2,2,7,10,11096
1453,1453,2014-06-09,5,6,14,22,11118
1454,1454,2014-06-10,7,13,12,19,11137
1455,1455,2014-06-11,1,3,3,3,11140
1456,1456,2014-06-12,6,8,9,0,11140
1457,1457,2014-06-13,0,2,7,11,11151
1458,1458,2014-06-14,1,1,3,5,11156
1459,1459,2014-06-15,5,7,10,13,11169
1460,1460,2014-06-16,5,8,5,10,11179
1461,1461,2014-06-17,0,1,5,7,11186
1462,1462,2014-06-18,5,6,21,36,11222
1463,1463,2014-06-19,0,0,1,1,11223
1464,1464,2014-06-20,0,1,2,2,11225
1465,1465,2014-06-21,0,0,3,6,11231
1466,1466,2014-06-22,2,4,9,16,11247
1467,1467,2014-06-23,0,1,3,5,11252
1468,1468,2014-06-24,156,180,147,286,11538
1469,1469,2014-06-25,2,2,9,12,11550
1470,1470,2014-06-26,6,9,8,-4,11546
1471,1471,2014-06-27,3,4,5,0,11546
1472,1472,2014-06-28,2,2,9,17,11563
1473,1473,2014-06-29,3,3,11,17,11580
1474,1474,2014-06-30,2,3,11,11,11591
1475,1475,2014-07-01,0,1,12,18,11609
1476,1476,2014-07-02,20,22,34,-2,11607
1477,1477,2014-07-03,2,4,10,18,11625
1478,1478,2014-07-04,0,1,7,9,11634
1479,1479,2014-07-05,0,0,3,5,11639
1480,1480,2014-07-06,0,0,11,20,11659
1481,1481,2014-07-07,0,0,12,24,11683
1482,1482,2014-07-08,1,1,10,12,11695
1483,1483,2014-07-09,3,12,8,22,11717
1484,1484,2014-07-10,1,1,12,19,11736
1485,1485,2014-07-11,1,3,12,10,11746
1486,1486,2014-07-12,1,2,15,24,11770
1487,1487,2014-07-13,0,1,7,10,11780
1488,1488,2014-07-14,2,8,4,9,11789
1489,1489,2014-07-15,3,7,12,24,11813
1490,1490,2014-07-16,0,1,10,17,11830
1491,1491,2014-07-17,0,0,4,8,11838
1492,1492,2014-07-18,0,0,11,20,11858
1493,1493,2014-07-19,0,2,7,10,11868
1494,1494,2014-07-20,2,2,6,11,11879
1495,1495,2014-07-21,3,6,17,10,11889
1496,1496,2014-07-22,1,2,13,14,11903
1497,1497,2014-07-23,2,5,23,45,11948
1498,1498,2014-07-24,2,3,11,15,11963
1499,1499,2014-07-25,0,2,6,11,11974
1500,1500,2014-07-26,0,0,6,9,11983
1501,1501,2014-07-27,1,1,13,25,12008
1502,1502,2014-07-28,1,3,16,25,12033
1503,1503,2014-07-29,9,9,26,39,12072
1504,1504,2014-07-30,0,0,5,9,12081
1505,1505,2014-07-31,7,13,17,28,12109
1506,1506,2014-08-01,2,3,18,34,12143
1507,1507,2014-08-02,1,3,19,34,12177
1508,1508,2014-08-03,5,6,17,23,12200
1509,1509,2014-08-04,1,1,7,8,12208
1510,1510,2014-08-05,2,8,4,19,12227
1511,1511,2014-08-06,0,1,9,12,12239
1512,1512,2014-08-07,0,0,7,11,12250
1513,1513,2014-08-08,0,0,12,15,12265
1514,1514,2014-08-09,22,25,26,47,12312
1515,1515,2014-08-10,3,5,9,14,12326
1516,1516,2014-08-11,0,1,16,20,12346
1517,1517,2014-08-12,0,0,10,19,12365
1518,1518,2014-08-13,2,3,10,11,12376
1519,1519,2014-08-14,0,0,4,7,12383
1520,1520,2014-08-15,15,20,27,37,12420
1521,1521,2014-08-16,6,6,10,20,12440
1522,1522,2014-08-17,0,1,12,19,12459
1523,1523,2014-08-18,2,4,10,11,12470
1524,1524,2014-08-19,12,18,38,54,12524
1525,1525,2014-08-20,0,0,2,4,12528
1526,1526,2014-08-21,0,1,4,8,12536
1527,1527,2014-08-22,0,1,12,22,12558
1528,1528,2014-08-23,1,3,6,6,12564
1529,1529,2014-08-24,0,0,9,14,12578
1530,1530,2014-08-25,0,4,15,26,12604
1531,1531,2014-08-26,0,0,6,7,12611
1532,1532,2014-08-27,3,5,20,37,12648
1533,1533,2014-08-28,4,7,8,6,12654
1534,1534,2014-08-29,1,1,16,29,12683
1535,1535,2014-08-30,0,1,5,10,12693
1536,1536,2014-08-31,3,3,19,29,12722
1537,1537,2014-09-01,4,4,9,8,12730
1538,1538,2014-09-02,0,0,11,13,12743
1539,1539,2014-09-03,0,0,19,21,12764
1540,1540,2014-09-04,15,16,32,58,12822
1541,1541,2014-09-05,0,1,6,9,12831
1542,1542,2014-09-06,2,5,10,21,12852
1543,1543,2014-09-07,0,0,5,8,12860
1544,1544,2014-09-08,1,2,12,20,12880
1545,1545,2014-09-09,4,4,12,15,12895
1546,1546,2014-09-10,0,1,20,30,12925
1547,1547,2014-09-11,1,1,17,18,12943
1548,1548,2014-09-12,1,2,8,12,12955
1549,1549,2014-09-13,0,0,4,3,12958
1550,1550,2014-09-14,7,10,26,45,13003
1551,1551,2014-09-15,2,2,16,25,13028
1552,1552,2014-09-16,0,0,10,11,13039
1553,1553,2014-09-17,1,3,29,32,13071
1554,1554,2014-09-18,5,7,18,8,13079
1555,1555,2014-09-19,0,0,14,24,13103
1556,1556,2014-09-20,0,2,6,11,13114
1557,1557,2014-09-21,1,1,10,17,13131
1558,1558,2014-09-22,7,12,18,3,13134
1559,1559,2014-09-23,1,10,5,27,13161
1560,1560,2014-09-24,4,6,18,33,13194
1561,1561,2014-09-25,0,0,11,18,13212
1562,1562,2014-09-26,7,8,16,31,13243
1563,1563,2014-09-27,2,8,2,24,13267
1564,1564,2014-09-28,0,1,13,20,13287
1565,1565,2014-09-29,0,0,20,33,13320
1566,1566,2014-09-30,12,17,24,6,13326
1567,1567,2014-10-01,4,6,11,22,13348
1568,1568,2014-10-02,9,14,21,11,13359
1569,1569,2014-10-03,4,6,16,17,13376
1570,1570,2014-10-04,1,1,9,14,13390
1571,1571,2014-10-05,3,5,13,8,13398
1572,1572,2014-10-06,3,4,19,37,13435
1573,1573,2014-10-07,0,0,8,14,13449
1574,1574,2014-10-08,0,0,14,26,13475
1575,1575,2014-10-09,2,3,18,30,13505
1576,1576,2014-10-10,1,3,4,5,13510
1577,1577,2014-10-11,2,2,18,29,13539
1578,1578,2014-10-12,0,0,6,10,13549
1579,1579,2014-10-13,3,3,17,29,13578
1580,1580,2014-10-14,2,3,16,20,13598
1581,1581,2014-10-15,0,1,13,19,13617
1582,1582,2014-10-16,3,6,17,29,13646
1583,1583,2014-10-17,1,2,16,26,13672
1584,1584,2014-10-18,13,13,18,35,13707
1585,1585,2014-10-19,7,7,15,16,13723
1586,1586,2014-10-20,4,6,19,34,13757
1587,1587,2014-10-21,0,0,12,18,13775
1588,1588,2014-10-22,0,1,6,12,13787
1589,1589,2014-10-23,2,4,11,16,13803
1590,1590,2014-10-24,1,1,21,37,13840
1591,1591,2014-10-25,0,0,6,7,13847
1592,1592,2014-10-26,0,0,12,23,13870
1593,1593,2014-10-27,1,3,12,19,13889
1594,1594,2014-10-28,2,2,13,19,13908
1595,1595,2014-10-29,1,2,15,24,13932
1596,1596,2014-10-30,7,8,14,24,13956
1597,1597,2014-10-31,0,0,17,22,13978
1598,1598,2014-11-01,8,9,25,42,14020
1599,1599,2014-11-02,0,0,5,7,14027
1600,1600,2014-11-03,0,2,11,19,14046
1601,1601,2014-11-04,18,22,28,54,14100
1602,1602,2014-11-05,1,4,23,31,14131
1603,1603,2014-11-06,0,0,17,25,14156
1604,1604,2014-11-07,0,2,8,15,14171
1605,1605,2014-11-08,1,1,8,15,14186
1606,1606,2014-11-09,3,5,13,7,14193
1607,1607,2014-11-10,4,5,18,29,14222
1608,1608,2014-11-11,1,2,8,11,14233
1609,1609,2014-11-12,6,7,18,28,14261
1610,1610,2014-11-13,1,2,15,20,14281
1611,1611,2014-11-14,0,1,15,27,14308
1612,1612,2014-11-15,1,1,11,14,14322
1613,1613,2014-11-16,2,2,22,41,14363
1614,1614,2014-11-17,4,4,20,30,14393
1615,1615,2014-11-18,1,1,11,17,14410
1616,1616,2014-11-19,0,1,18,35,14445
1617,1617,2014-11-20,1,1,14,17,14462
1618,1618,2014-11-21,0,0,6,12,14474
1619,1619,2014-11-22,1,7,6,25,14499
1620,1620,2014-11-23,0,1,10,12,14511
1621,1621,2014-11-24,10,15,26,51,14562
1622,1622,2014-11-25,42,43,66,120,14682
1623,1623,2014-11-26,3,3,14,11,14693
1624,1624,2014-11-27,1,2,8,11,14704
1625,1625,2014-11-28,0,0,7,11,14715
1626,1626,2014-11-29,1,3,6,12,14727
1627,1627,2014-11-30,0,0,8,12,14739
1628,1628,2014-12-01,0,0,4,6,14745
1629,1629,2014-12-02,7,8,25,36,14781
1630,1630,2014-12-03,2,3,14,21,14802
1631,1631,2014-12-04,4,9,5,1,14803
1632,1632,2014-12-05,4,5,23,33,14836
1633,1633,2014-12-06,11,14,33,20,14856
1634,1634,2014-12-07,0,1,10,18,14874
1635,1635,2014-12-08,2,3,13,12,14886
1636,1636,2014-12-09,5,10,23,38,14924
1637,1637,2014-12-10,3,5,19,31,14955
1638,1638,2014-12-11,2,7,16,25,14980
1639,1639,2014-12-12,5,5,17,8,14988
1640,1640,2014-12-13,1,2,8,5,14993
1641,1641,2014-12-14,1,2,15,22,15015
1642,1642,2014-12-15,8,9,26,51,15066
1643,1643,2014-12-16,1,3,9,14,15080
1644,1644,2014-12-17,6,7,22,37,15117
1645,1645,2014-12-18,4,7,17,27,15144
1646,1646,2014-12-19,1,3,10,19,15163
1647,1647,2014-12-20,4,8,15,18,15181
1648,1648,2014-12-21,2,4,6,8,15189
1649,1649,2014-12-22,1,2,13,17,15206
1650,1650,2014-12-23,52,58,66,126,15332
1651,1651,2014-12-24,1,2,14,21,15353
1652,1652,2014-12-26,2,2,17,24,15377
1653,1653,2014-12-27,0,2,18,32,15409
1654,1654,2014-12-28,0,2,9,11,15420
1655,1655,2014-12-29,1,4,24,44,15464
1656,1656,2014-12-30,0,1,14,23,15487
1657,1657,2014-12-31,2,6,9,15,15502
1658,1658,2015-01-01,1,5,9,14,15516
1659,1659,2015-01-02,7,8,28,20,15536
1660,1660,2015-01-03,0,1,22,43,15579
1661,1661,2015-01-04,0,0,17,33,15612
1662,1662,2015-01-05,2,3,28,41,15653
1663,1663,2015-01-06,7,8,25,42,15695
1664,1664,2015-01-07,6,7,25,49,15744
1665,1665,2015-01-08,4,6,26,42,15786
1666,1666,2015-01-09,6,8,24,26,15812
1667,1667,2015-01-10,0,1,8,6,15818
1668,1668,2015-01-11,2,3,10,8,15826
1669,1669,2015-01-12,0,0,14,24,15850
1670,1670,2015-01-13,40,46,47,-60,15790
1671,1671,2015-01-14,3,5,15,16,15806
1672,1672,2015-01-15,1,2,11,15,15821
1673,1673,2015-01-16,1,3,15,21,15842
1674,1674,2015-01-17,1,2,3,2,15844
1675,1675,2015-01-18,3,5,23,39,15883
1676,1676,2015-01-19,0,0,10,15,15898
1677,1677,2015-01-20,2,3,17,21,15919
1678,1678,2015-01-21,8,11,30,31,15950
1679,1679,2015-01-22,1,4,13,12,15962
1680,1680,2015-01-23,0,0,3,4,15966
1681,1681,2015-01-24,0,0,2,3,15969
1682,1682,2015-01-25,2,5,4,12,15981
1683,1683,2015-01-26,0,1,6,8,15989
1684,1684,2015-01-27,0,3,19,28,16017
1685,1685,2015-01-28,0,2,21,40,16057
1686,1686,2015-01-29,1,2,13,20,16077
1687,1687,2015-01-30,5,7,19,30,16107
1688,1688,2015-01-31,2,3,7,3,16110
1689,1689,2015-02-01,15,18,23,7,16117
1690,1690,2015-02-02,4,6,11,0,16117
1691,1691,2015-02-03,2,3,9,11,16128
1692,1692,2015-02-04,0,0,14,20,16148
1693,1693,2015-02-05,0,0,5,10,16158
1694,1694,2015-02-06,57,80,136,207,16365
1695,1695,2015-02-07,0,1,16,23,16388
1696,1696,2015-02-08,1,1,11,9,16397
1697,1697,2015-02-09,4,6,19,21,16418
1698,1698,2015-02-10,1,4,11,15,16433
1699,1699,2015-02-11,1,1,20,17,16450
1700,1700,2015-02-12,8,12,23,11,16461
1701,1701,2015-02-13,3,6,23,34,16495
1702,1702,2015-02-14,6,9,21,14,16509
1703,1703,2015-02-15,4,5,11,19,16528
1704,1704,2015-02-16,4,5,27,46,16574
1705,1705,2015-02-17,1,1,7,6,16580
1706,1706,2015-02-18,0,5,10,19,16599
1707,1707,2015-02-19,5,6,17,27,16626
1708,1708,2015-02-20,8,12,22,19,16645
1709,1709,2015-02-21,3,7,25,41,16686
1710,1710,2015-02-22,4,5,12,13,16699
1711,1711,2015-02-23,6,12,24,42,16741
1712,1712,2015-02-24,2,2,14,26,16767
1713,1713,2015-02-25,2,3,10,1,16768
1714,1714,2015-02-26,4,4,20,29,16797
1715,1715,2015-02-27,6,6,25,34,16831
1716,1716,2015-02-28,5,10,21,27,16858
1717,1717,2015-03-01,4,6,18,24,16882
1718,1718,2015-03-02,4,6,21,35,16917
1719,1719,2015-03-03,1,3,20,20,16937
1720,1720,2015-03-04,9,12,23,33,16970
1721,1721,2015-03-05,0,0,14,20,16990
1722,1722,2015-03-06,15,15,52,78,17068
1723,1723,2015-03-07,1,1,10,13,17081
1724,1724,2015-03-08,12,15,26,48,17129
1725,1725,2015-03-09,3,5,20,29,17158
1726,1726,2015-03-10,3,6,18,34,17192
1727,1727,2015-03-11,1,1,20,30,17222
1728,1728,2015-03-12,3,6,16,9,17231
1729,1729,2015-03-13,1,2,13,18,17249
1730,1730,2015-03-14,1,2,6,9,17258
1731,1731,2015-03-15,0,2,13,25,17283
1732,1732,2015-03-16,8,10,18,4,17287
1733,1733,2015-03-17,7,9,22,30,17317
1734,1734,2015-03-18,6,11,11,22,17339
1735,1735,2015-03-19,2,4,11,16,17355
1736,1736,2015-03-20,7,11,15,22,17377
1737,1737,2015-03-21,0,0,8,15,17392
1738,1738,2015-03-22,65,70,73,-48,17344
1739,1739,2015-03-23,8,11,29,28,17372
1740,1740,2015-03-24,5,8,18,13,17385
1741,1741,2015-03-25,4,5,18,32,17417
1742,1742,2015-03-26,10,14,25,40,17457
1743,1743,2015-03-27,0,0,16,29,17486
1744,1744,2015-03-28,17,18,29,54,17540
1745,1745,2015-03-29,0,0,7,13,17553
1746,1746,2015-03-30,3,5,21,35,17588
1747,1747,2015-03-31,9,14,23,29,17617
1748,1748,2015-04-01,5,8,18,22,17639
1749,1749,2015-04-02,32,47,35,-3,17636
1750,1750,2015-04-03,5,8,24,47,17683
1751,1751,2015-04-04,0,1,6,4,17687
1752,1752,2015-04-05,0,6,9,25,17712
1753,1753,2015-04-06,0,1,15,22,17734
1754,1754,2015-04-07,1,3,23,39,17773
1755,1755,2015-04-08,1,3,14,20,17793
1756,1756,2015-04-09,6,8,17,3,17796
1757,1757,2015-04-10,1,4,11,9,17805
1758,1758,2015-04-11,0,51,-35,69,17874
1759,1759,2015-04-12,2,3,17,30,17904
1760,1760,2015-04-13,3,3,13,21,17925
1761,1761,2015-04-14,2,4,18,20,17945
1762,1762,2015-04-15,1,2,12,15,17960
1763,1763,2015-04-16,0,1,11,15,17975
1764,1764,2015-04-17,6,6,24,43,18018
1765,1765,2015-04-18,1,2,13,19,18037
1766,1766,2015-04-19,1,2,20,30,18067
1767,1767,2015-04-20,19,25,25,-13,18054
1768,1768,2015-04-21,23,25,33,51,18105
1769,1769,2015-04-22,1,2,10,18,18123
1770,1770,2015-04-23,4,6,26,44,18167
1771,1771,2015-04-24,9,14,23,32,18199
1772,1772,2015-04-25,4,5,10,7,18206
1773,1773,2015-04-26,3,5,17,18,18224
1774,1774,2015-04-27,4,5,18,24,18248
1775,1775,2015-04-28,3,4,18,30,18278
1776,1776,2015-04-29,2,5,19,32,18310
1777,1777,2015-04-30,4,5,25,26,18336
1778,1778,2015-05-01,4,7,13,2,18338
1779,1779,2015-05-02,1,1,9,18,18356
1780,1780,2015-05-03,1,1,10,11,18367
1781,1781,2015-05-04,5,6,23,28,18395
1782,1782,2015-05-05,0,2,10,18,18413
1783,1783,2015-05-06,4,4,22,25,18438
1784,1784,2015-05-07,0,0,7,9,18447
1785,1785,2015-05-08,3,3,12,14,18461
1786,1786,2015-05-09,3,5,13,5,18466
1787,1787,2015-05-10,1,1,7,12,18478
1788,1788,2015-05-11,6,10,14,24,18502
1789,1789,2015-05-12,2,3,16,21,18523
1790,1790,2015-05-13,1,1,9,4,18527
1791,1791,2015-05-14,5,5,15,13,18540
1792,1792,2015-05-15,1,1,13,19,18559
1793,1793,2015-05-16,5,5,16,26,18585
1794,1794,2015-05-17,3,8,12,15,18600
1795,1795,2015-05-18,1,5,21,42,18642
1796,1796,2015-05-19,0,1,11,17,18659
1797,1797,2015-05-20,0,2,6,10,18669
1798,1798,2015-05-21,1,2,8,10,18679
1799,1799,2015-05-22,27,29,32,-38,18641
1800,1800,2015-05-23,1,1,4,8,18649
1801,1801,2015-05-24,0,0,5,6,18655
1802,1802,2015-05-25,0,0,8,16,18671
1803,1803,2015-05-26,2,4,16,19,18690
1804,1804,2015-05-27,9,10,26,47,18737
1805,1805,2015-05-28,5,10,23,21,18758
1806,1806,2015-05-29,0,0,9,11,18769
1807,1807,2015-05-30,1,2,24,46,18815
1808,1808,2015-05-31,3,3,19,29,18844
1809,1809,2015-06-01,0,0,7,4,18848
1810,1810,2015-06-02,5,9,19,28,18876
1811,1811,2015-06-03,30,42,29,1,18877
1812,1812,2015-06-04,0,2,12,19,18896
1813,1813,2015-06-05,1,5,15,29,18925
1814,1814,2015-06-06,0,2,6,9,18934
1815,1815,2015-06-07,4,5,15,12,18946
1816,1816,2015-06-08,3,7,21,40,18986
1817,1817,2015-06-09,1,2,17,15,19001
1818,1818,2015-06-10,1,2,3,6,19007
1819,1819,2015-06-11,7,8,18,-1,19006
1820,1820,2015-06-12,11,14,18,6,19012
1821,1821,2015-06-13,1,1,9,13,19025
1822,1822,2015-06-14,5,8,14,9,19034
1823,1823,2015-06-15,6,7,20,16,19050
1824,1824,2015-06-16,1,2,9,7,19057
1825,1825,2015-06-17,0,0,9,17,19074
1826,1826,2015-06-18,3,4,16,22,19096
1827,1827,2015-06-19,2,3,12,13,19109
1828,1828,2015-06-20,4,4,21,37,19146
1829,1829,2015-06-21,8,9,23,11,19157
1830,1830,2015-06-22,7,10,23,43,19200
1831,1831,2015-06-23,2,4,22,34,19234
1832,1832,2015-06-24,4,6,17,16,19250
1833,1833,2015-06-25,0,0,5,3,19253
1834,1834,2015-06-26,0,0,8,15,19268
1835,1835,2015-06-27,3,5,16,26,19294
1836,1836,2015-06-28,5,8,17,27,19321
1837,1837,2015-06-29,2,3,21,30,19351
1838,1838,2015-06-30,1,1,14,27,19378
1839,1839,2015-07-01,48,52,55,-70,19308
1840,1840,2015-07-02,3,3,20,32,19340
1841,1841,2015-07-03,4,5,13,14,19354
1842,1842,2015-07-04,12,15,14,23,19377
1843,1843,2015-07-05,3,4,12,9,19386
1844,1844,2015-07-06,8,9,20,28,19414
1845,1845,2015-07-07,8,11,23,34,19448
1846,1846,2015-07-08,3,6,15,27,19475
1847,1847,2015-07-09,2,3,13,23,19498
1848,1848,2015-07-10,3,5,15,30,19528
1849,1849,2015-07-11,0,0,17,27,19555
1850,1850,2015-07-12,2,4,22,39,19594
1851,1851,2015-07-13,2,6,15,30,19624
1852,1852,2015-07-14,4,5,16,25,19649
1853,1853,2015-07-15,1,1,13,16,19665
1854,1854,2015-07-16,1,6,18,33,19698
1855,1855,2015-07-17,4,4,21,20,19718
1856,1856,2015-07-18,2,4,17,24,19742
1857,1857,2015-07-19,0,3,12,9,19751
1858,1858,2015-07-20,2,2,16,29,19780
1859,1859,2015-07-21,18,23,45,23,19803
1860,1860,2015-07-22,2,2,20,33,19836
1861,1861,2015-07-23,46,60,51,-39,19797
1862,1862,2015-07-24,1,2,11,20,19817
1863,1863,2015-07-25,3,6,13,16,19833
1864,1864,2015-07-26,0,1,4,8,19841
1865,1865,2015-07-27,6,9,39,53,19894
1866,1866,2015-07-28,27,42,28,0,19894
1867,1867,2015-07-29,1,3,20,28,19922
1868,1868,2015-07-30,0,2,7,12,19934
1869,1869,2015-07-31,0,2,17,25,19959
1870,1870,2015-08-01,3,4,21,39,19998
1871,1871,2015-08-02,6,9,15,13,20011
1872,1872,2015-08-03,0,0,11,14,20025
1873,1873,2015-08-04,2,5,18,29,20054
1874,1874,2015-08-05,2,3,27,40,20094
1875,1875,2015-08-06,7,10,24,29,20123
1876,1876,2015-08-07,23,26,48,68,20191
1877,1877,2015-08-08,1,1,7,11,20202
1878,1878,2015-08-09,2,4,10,10,20212
1879,1879,2015-08-10,0,0,7,14,20226
1880,1880,2015-08-11,15,17,27,38,20264
1881,1881,2015-08-12,0,1,5,10,20274
1882,1882,2015-08-13,8,12,18,23,20297
1883,1883,2015-08-14,1,1,14,21,20318
1884,1884,2015-08-15,0,3,6,8,20326
1885,1885,2015-08-16,1,1,10,13,20339
1886,1886,2015-08-17,6,7,25,26,20365
1887,1887,2015-08-18,3,3,23,33,20398
1888,1888,2015-08-19,0,0,17,29,20427
1889,1889,2015-08-20,4,6,22,30,20457
1890,1890,2015-08-21,1,1,21,35,20492
1891,1891,2015-08-22,2,2,6,8,20500
1892,1892,2015-08-23,0,1,10,16,20516
1893,1893,2015-08-24,0,0,16,23,20539
1894,1894,2015-08-25,4,5,22,34,20573
1895,1895,2015-08-26,1,1,17,25,20598
1896,1896,2015-08-27,11,12,29,37,20635
1897,1897,2015-08-28,16,20,21,17,20652
1898,1898,2015-08-29,0,0,9,14,20666
1899,1899,2015-08-30,2,3,10,19,20685
1900,1900,2015-08-31,0,0,15,27,20712
